Date,Sales,Expenses,Region,Customer_Satisfaction_Score,Website_Visits,Ad_Spend,Product_Category,Profit
01-01-2023 00:00,3539,2382,East,50,1415,398,Furniture,1157
01-01-2023 01:00,3960,1422,West,72,554,899,Electronics,2538
01-01-2023 02:00,4324,2675,South,80,1996,328,Clothing,1649
01-01-2023 03:00,4301,1949,East,84,1770,995,Furniture,2352
01-01-2023 04:00,2542,2082,North,96,1962,730,Furniture,460
01-01-2023 05:00,2197,1064,North,94,813,369,Groceries,1133
01-01-2023 06:00,2676,970,West,71,1843,180,Electronics,1706
01-01-2023 07:00,2191,1487,North,95,719,771,Clothing,704
01-01-2023 08:00,3217,2434,South,56,1894,287,Furniture,783
01-01-2023 09:00,2416,723,East,82,1739,799,Groceries,1693
01-01-2023 10:00,3993,2701,South,94,548,919,Furniture,1292
01-01-2023 11:00,3842,850,South,85,962,600,Furniture,2992
01-01-2023 12:00,3681,2428,South,93,617,805,Electronics,1253
01-01-2023 13:00,2217,848,South,56,581,586,Groceries,1369
01-01-2023 14:00,2540,681,East,76,1786,871,Groceries,1859
01-01-2023 15:00,3076,1136,East,51,995,587,Clothing,1940
01-01-2023 16:00,4236,1517,South,66,1133,577,Furniture,2719
01-01-2023 17:00,2445,2726,South,50,1336,802,Groceries,-281
01-01-2023 18:00,3386,1271,North,95,1101,388,Furniture,2115
01-01-2023 19:00,4719,1515,North,79,1269,205,Furniture,3204
01-01-2023 20:00,2519,2611,East,71,1172,740,Clothing,-92
01-01-2023 21:00,2388,528,North,77,675,708,Clothing,1860
01-01-2023 22:00,2856,2919,East,82,1304,675,Groceries,-63
01-01-2023 23:00,2365,2644,East,75,1612,739,Furniture,-279
02-01-2023 00:00,1499,2393,West,84,1138,322,Groceries,-894
02-01-2023 01:00,2680,1965,East,60,1882,904,Furniture,715
02-01-2023 02:00,1510,1726,North,56,1809,481,Groceries,-216
02-01-2023 03:00,4398,2568,West,77,796,937,Groceries,1830
02-01-2023 04:00,1216,1625,North,74,1783,203,Furniture,-409
02-01-2023 05:00,2324,565,East,90,974,763,Electronics,1759
02-01-2023 06:00,2155,1634,East,80,1035,213,Clothing,521
02-01-2023 07:00,2827,837,South,52,1560,607,Furniture,1990
02-01-2023 08:00,4141,2670,East,82,1704,154,Groceries,1471
02-01-2023 09:00,4323,2228,West,83,524,220,Electronics,2095
02-01-2023 10:00,4486,946,East,70,848,316,Groceries,3540
02-01-2023 11:00,2810,780,South,86,1136,734,Electronics,2030
02-01-2023 12:00,3492,1095,East,98,726,102,Furniture,2397
02-01-2023 13:00,3923,2486,East,68,1871,191,Clothing,1437
02-01-2023 14:00,2205,1574,East,86,537,506,Groceries,631
02-01-2023 15:00,3214,709,South,70,1906,775,Electronics,2505
02-01-2023 16:00,1090,625,North,63,1069,540,Electronics,465
02-01-2023 17:00,1713,991,East,59,735,730,Clothing,722
02-01-2023 18:00,2881,1469,West,56,1704,531,Groceries,1412
02-01-2023 19:00,4602,1080,South,78,613,160,Furniture,3522
02-01-2023 20:00,1038,2805,West,89,805,825,Furniture,-1767
02-01-2023 21:00,4197,1711,East,57,631,572,Groceries,2486
02-01-2023 22:00,4522,729,South,88,847,346,Clothing,3793
02-01-2023 23:00,1172,688,East,62,1703,846,Clothing,484
03-01-2023 00:00,1652,2557,West,95,914,968,Clothing,-905
03-01-2023 01:00,1753,1001,South,68,1482,471,Electronics,752
03-01-2023 02:00,2243,2632,North,60,1231,388,Electronics,-389
03-01-2023 03:00,4709,548,North,51,1153,689,Clothing,4161
03-01-2023 04:00,2081,1188,North,98,884,123,Groceries,893
03-01-2023 05:00,2683,886,East,55,1011,505,Furniture,1797
03-01-2023 06:00,3523,1469,South,78,1566,407,Electronics,2054
03-01-2023 07:00,1455,1505,West,90,1641,712,Clothing,-50
03-01-2023 08:00,1828,2765,West,54,560,471,Electronics,-937
03-01-2023 09:00,1894,2224,East,90,1052,862,Electronics,-330
03-01-2023 10:00,2384,2504,East,79,687,734,Clothing,-120
03-01-2023 11:00,2958,2802,West,88,952,314,Groceries,156
03-01-2023 12:00,4072,2783,South,85,1346,361,Furniture,1289
03-01-2023 13:00,3434,2107,East,76,686,943,Groceries,1327
03-01-2023 14:00,2996,2289,South,99,1437,445,Electronics,707
03-01-2023 15:00,3395,770,West,67,1987,512,Groceries,2625
03-01-2023 16:00,1189,622,South,98,663,222,Groceries,567
03-01-2023 17:00,1504,1780,North,85,1947,863,Furniture,-276
03-01-2023 18:00,2214,1944,West,65,601,419,Clothing,270
03-01-2023 19:00,2531,758,North,54,1790,436,Clothing,1773
03-01-2023 20:00,4440,1447,West,58,1676,257,Clothing,2993
03-01-2023 21:00,4480,2594,North,83,1952,426,Groceries,1886
03-01-2023 22:00,1823,1362,South,83,1190,760,Groceries,461
03-01-2023 23:00,1928,1024,West,85,1950,164,Furniture,904
04-01-2023 00:00,1933,1387,West,80,1077,468,Clothing,546
04-01-2023 01:00,2140,707,North,69,1110,969,Furniture,1433
04-01-2023 02:00,1133,648,South,66,1035,103,Furniture,485
04-01-2023 03:00,3105,937,West,69,1856,785,Groceries,2168
04-01-2023 04:00,4627,2702,East,77,1260,747,Clothing,1925
04-01-2023 05:00,1684,2221,North,70,1395,855,Electronics,-537
04-01-2023 06:00,3719,857,West,68,1963,159,Electronics,2862
04-01-2023 07:00,3220,1740,South,52,1470,144,Groceries,1480
04-01-2023 08:00,2852,2430,South,79,623,683,Groceries,422
04-01-2023 09:00,1814,955,South,54,1825,706,Groceries,859
04-01-2023 10:00,2172,2132,South,91,1167,642,Groceries,40
04-01-2023 11:00,1079,1128,North,55,848,255,Electronics,-49
04-01-2023 12:00,3933,985,West,52,748,987,Clothing,2948
04-01-2023 13:00,4284,699,North,98,1794,851,Furniture,3585
04-01-2023 14:00,1202,870,North,91,1952,163,Electronics,332
04-01-2023 15:00,3811,1513,South,73,1206,520,Clothing,2298
04-01-2023 16:00,2252,2482,East,93,1212,422,Groceries,-230
04-01-2023 17:00,2699,1971,South,50,1506,208,Furniture,728
04-01-2023 18:00,2250,747,East,99,746,562,Clothing,1503
04-01-2023 19:00,2682,1287,North,85,980,679,Clothing,1395
04-01-2023 20:00,2555,2811,South,64,597,646,Furniture,-256
04-01-2023 21:00,4512,2578,South,90,828,350,Clothing,1934
04-01-2023 22:00,4473,2021,North,87,1948,965,Clothing,2452
04-01-2023 23:00,3094,1772,South,93,1947,609,Furniture,1322
05-01-2023 00:00,2256,1104,West,67,1528,647,Furniture,1152
05-01-2023 01:00,4376,2189,East,72,958,540,Electronics,2187
05-01-2023 02:00,2549,1917,East,96,1295,553,Groceries,632
05-01-2023 03:00,2166,2320,East,78,1092,743,Groceries,-154
05-01-2023 04:00,4486,1001,South,90,997,916,Clothing,3485
05-01-2023 05:00,4584,1048,West,71,586,833,Groceries,3536
05-01-2023 06:00,2396,1865,South,73,901,778,Electronics,531
05-01-2023 07:00,4637,1338,East,94,1816,373,Clothing,3299
05-01-2023 08:00,4957,1930,South,97,1804,159,Groceries,3027
05-01-2023 09:00,4330,1948,East,62,696,441,Groceries,2382
05-01-2023 10:00,3703,1347,North,82,1263,493,Clothing,2356
05-01-2023 11:00,1470,1113,East,99,1606,212,Furniture,357
05-01-2023 12:00,4018,911,North,71,526,320,Electronics,3107
05-01-2023 13:00,2035,2979,North,84,634,890,Clothing,-944
05-01-2023 14:00,2353,1177,North,66,1613,167,Clothing,1176
05-01-2023 15:00,3783,658,East,71,705,414,Groceries,3125
05-01-2023 16:00,3831,2561,West,54,1550,566,Furniture,1270
05-01-2023 17:00,1967,872,East,74,1901,957,Groceries,1095
05-01-2023 18:00,1357,2772,South,55,1938,362,Clothing,-1415
05-01-2023 19:00,4019,1596,South,66,1750,880,Clothing,2423
05-01-2023 20:00,4479,1102,West,80,1102,230,Groceries,3377
05-01-2023 21:00,1667,715,West,66,1591,523,Furniture,952
05-01-2023 22:00,1372,2496,West,82,861,366,Clothing,-1124
05-01-2023 23:00,2031,2064,North,88,1783,819,Electronics,-33
06-01-2023 00:00,2145,2340,West,97,1157,311,Furniture,-195
06-01-2023 01:00,2371,2462,West,86,1586,662,Clothing,-91
06-01-2023 02:00,3723,1226,West,97,1471,387,Furniture,2497
06-01-2023 03:00,1089,1744,East,53,1479,524,Furniture,-655
06-01-2023 04:00,4719,1565,South,92,1440,653,Electronics,3154
06-01-2023 05:00,3745,1175,South,63,1407,858,Clothing,2570
06-01-2023 06:00,4387,782,West,62,1915,806,Furniture,3605
06-01-2023 07:00,4249,1581,South,76,745,343,Clothing,2668
06-01-2023 08:00,1539,2408,East,73,777,811,Clothing,-869
06-01-2023 09:00,3779,1652,South,76,846,969,Furniture,2127
06-01-2023 10:00,1868,1447,North,57,871,732,Groceries,421
06-01-2023 11:00,1040,1164,East,96,1308,433,Furniture,-124
06-01-2023 12:00,1739,2217,South,99,1348,427,Groceries,-478
06-01-2023 13:00,4775,1648,South,88,622,814,Groceries,3127
06-01-2023 14:00,2946,566,East,70,1580,205,Groceries,2380
06-01-2023 15:00,3549,2553,South,90,659,861,Groceries,996
06-01-2023 16:00,4006,1136,South,60,1650,986,Furniture,2870
06-01-2023 17:00,4216,813,West,80,1236,900,Groceries,3403
06-01-2023 18:00,2224,1064,North,76,1834,178,Clothing,1160
06-01-2023 19:00,1928,2101,East,91,1017,264,Furniture,-173
06-01-2023 20:00,3036,1325,West,95,1434,945,Electronics,1711
06-01-2023 21:00,4795,1605,South,97,1788,730,Groceries,3190
06-01-2023 22:00,3508,1525,East,76,1245,156,Furniture,1983
06-01-2023 23:00,3779,2751,East,57,787,287,Groceries,1028
07-01-2023 00:00,3799,1161,North,82,919,151,Clothing,2638
07-01-2023 01:00,1924,1304,North,61,639,171,Groceries,620
07-01-2023 02:00,3956,2951,East,84,1206,852,Furniture,1005
07-01-2023 03:00,2581,1035,North,83,1197,423,Clothing,1546
07-01-2023 04:00,4618,1891,North,65,1486,711,Groceries,2727
07-01-2023 05:00,4324,1735,South,85,974,437,Electronics,2589
07-01-2023 06:00,1389,2420,North,51,888,254,Groceries,-1031
07-01-2023 07:00,2617,2664,North,61,1010,158,Groceries,-47
07-01-2023 08:00,3930,1127,West,76,1037,374,Clothing,2803
07-01-2023 09:00,1255,1248,South,66,712,870,Groceries,7
07-01-2023 10:00,1708,604,South,69,1396,300,Furniture,1104
07-01-2023 11:00,2838,545,East,70,1788,394,Furniture,2293
07-01-2023 12:00,2944,1854,North,79,1866,421,Clothing,1090
07-01-2023 13:00,3497,1739,West,91,1561,428,Furniture,1758
07-01-2023 14:00,1009,1481,West,69,732,489,Electronics,-472
07-01-2023 15:00,3871,1459,South,57,759,383,Groceries,2412
07-01-2023 16:00,1797,2015,North,67,807,275,Clothing,-218
07-01-2023 17:00,4313,2336,West,67,902,709,Furniture,1977
07-01-2023 18:00,4322,2996,East,67,1496,448,Electronics,1326
07-01-2023 19:00,1876,1981,North,51,1784,531,Electronics,-105
07-01-2023 20:00,2028,2059,North,61,1999,793,Clothing,-31
07-01-2023 21:00,4190,2007,North,81,1249,481,Clothing,2183
07-01-2023 22:00,2015,2563,West,91,1629,371,Furniture,-548
07-01-2023 23:00,2824,2500,South,57,1770,591,Groceries,324
08-01-2023 00:00,1373,2790,South,59,803,646,Electronics,-1417
08-01-2023 01:00,4136,2473,East,60,842,430,Electronics,1663
08-01-2023 02:00,3193,1411,West,63,1970,974,Clothing,1782
08-01-2023 03:00,1223,1794,North,75,1561,698,Electronics,-571
08-01-2023 04:00,2262,2302,East,96,1354,257,Clothing,-40
08-01-2023 05:00,3224,2253,East,79,1569,531,Groceries,971
08-01-2023 06:00,2802,614,South,91,1743,424,Clothing,2188
08-01-2023 07:00,1852,2103,North,53,755,215,Groceries,-251
08-01-2023 08:00,4353,1822,North,88,636,619,Furniture,2531
08-01-2023 09:00,1062,2360,West,60,1754,718,Clothing,-1298
08-01-2023 10:00,2240,2944,West,73,1317,718,Furniture,-704
08-01-2023 11:00,4925,2941,West,71,1472,725,Groceries,1984
08-01-2023 12:00,3874,1598,East,52,537,534,Electronics,2276
08-01-2023 13:00,3842,1477,North,86,1678,621,Furniture,2365
08-01-2023 14:00,1688,2005,South,51,604,895,Clothing,-317
08-01-2023 15:00,2484,1626,East,61,754,671,Clothing,858
08-01-2023 16:00,2633,796,East,70,1927,365,Furniture,1837
08-01-2023 17:00,3152,2725,South,54,987,497,Furniture,427
08-01-2023 18:00,4170,2862,South,56,957,201,Furniture,1308
08-01-2023 19:00,1510,1562,West,53,1027,162,Clothing,-52
08-01-2023 20:00,1384,758,South,92,1090,786,Furniture,626
08-01-2023 21:00,1404,2554,South,90,1024,808,Furniture,-1150
08-01-2023 22:00,3870,2596,South,85,869,923,Groceries,1274
08-01-2023 23:00,1517,2708,South,71,601,610,Furniture,-1191
09-01-2023 00:00,1475,2392,West,78,1415,321,Furniture,-917
09-01-2023 01:00,3000,675,East,58,1163,535,Clothing,2325
09-01-2023 02:00,3756,1500,North,75,1189,289,Clothing,2256
09-01-2023 03:00,4934,2418,North,61,1098,739,Electronics,2516
09-01-2023 04:00,2668,2167,East,97,1099,433,Clothing,501
09-01-2023 05:00,2893,775,North,50,1040,657,Clothing,2118
09-01-2023 06:00,3818,1175,North,57,888,680,Clothing,2643
09-01-2023 07:00,2460,2323,East,82,862,400,Clothing,137
09-01-2023 08:00,4094,1551,North,53,1430,450,Furniture,2543
09-01-2023 09:00,4044,1856,North,63,1111,975,Electronics,2188
09-01-2023 10:00,4636,2603,East,78,1638,669,Clothing,2033
09-01-2023 11:00,3724,1046,North,63,1221,827,Furniture,2678
09-01-2023 12:00,1713,1635,South,58,842,214,Clothing,78
09-01-2023 13:00,4529,2583,East,58,1597,621,Electronics,1946
09-01-2023 14:00,1082,2540,West,75,634,466,Groceries,-1458
09-01-2023 15:00,2168,938,North,98,1439,368,Groceries,1230
09-01-2023 16:00,4156,2252,West,96,1477,903,Electronics,1904
09-01-2023 17:00,4149,2115,North,91,879,185,Furniture,2034
09-01-2023 18:00,3504,2349,South,66,1648,995,Furniture,1155
09-01-2023 19:00,2901,2100,East,90,537,477,Electronics,801
09-01-2023 20:00,3048,2163,West,53,1280,246,Groceries,885
09-01-2023 21:00,1050,806,East,95,809,217,Clothing,244
09-01-2023 22:00,1684,1118,West,52,605,234,Groceries,566
09-01-2023 23:00,1716,1632,North,78,1055,626,Clothing,84
10-01-2023 00:00,4843,1895,South,74,1748,948,Electronics,2948
10-01-2023 01:00,2469,2904,West,70,1765,913,Electronics,-435
10-01-2023 02:00,1448,2728,West,61,896,305,Electronics,-1280
10-01-2023 03:00,1880,1879,South,50,652,332,Groceries,1
10-01-2023 04:00,1487,2199,South,50,1035,915,Electronics,-712
10-01-2023 05:00,2823,2615,South,94,1495,165,Groceries,208
10-01-2023 06:00,3081,2839,South,95,1465,103,Furniture,242
10-01-2023 07:00,4419,680,South,97,1925,102,Clothing,3739
10-01-2023 08:00,3142,2981,East,56,1669,358,Clothing,161
10-01-2023 09:00,4143,1987,North,59,1714,814,Clothing,2156
10-01-2023 10:00,2574,1413,North,64,1392,424,Electronics,1161
10-01-2023 11:00,3201,2057,West,89,1082,339,Clothing,1144
10-01-2023 12:00,1249,2613,South,60,700,704,Electronics,-1364
10-01-2023 13:00,1673,1544,East,95,511,895,Groceries,129
10-01-2023 14:00,1437,2135,East,94,1575,634,Electronics,-698
10-01-2023 15:00,3165,2931,West,72,1267,897,Clothing,234
10-01-2023 16:00,1770,2138,South,62,1825,417,Electronics,-368
10-01-2023 17:00,4962,2082,North,76,1823,698,Electronics,2880
10-01-2023 18:00,4377,2586,South,90,1419,150,Groceries,1791
10-01-2023 19:00,1267,1808,East,66,1020,908,Electronics,-541
10-01-2023 20:00,2984,1321,South,99,1663,569,Clothing,1663
10-01-2023 21:00,2077,1101,North,62,599,931,Electronics,976
10-01-2023 22:00,1235,2120,North,61,1660,142,Furniture,-885
10-01-2023 23:00,1388,1284,West,78,1370,303,Electronics,104
11-01-2023 00:00,4037,1711,East,70,865,446,Furniture,2326
11-01-2023 01:00,4805,1170,South,69,1156,157,Clothing,3635
11-01-2023 02:00,1762,1766,South,69,660,158,Furniture,-4
11-01-2023 03:00,2848,1596,West,80,1260,779,Furniture,1252
11-01-2023 04:00,3448,2497,West,57,674,785,Furniture,951
11-01-2023 05:00,1623,600,West,73,1611,610,Furniture,1023
11-01-2023 06:00,3814,2279,East,60,1922,417,Furniture,1535
11-01-2023 07:00,4374,675,South,88,1044,532,Electronics,3699
11-01-2023 08:00,3966,737,West,82,976,471,Groceries,3229
11-01-2023 09:00,4278,1622,East,91,782,306,Furniture,2656
11-01-2023 10:00,2252,2477,South,64,1456,210,Clothing,-225
11-01-2023 11:00,3900,2503,North,53,951,122,Clothing,1397
11-01-2023 12:00,4981,2037,West,50,581,527,Electronics,2944
11-01-2023 13:00,1577,1254,East,81,1736,844,Groceries,323
11-01-2023 14:00,3122,2758,South,60,1315,886,Groceries,364
11-01-2023 15:00,1434,1646,South,79,1019,783,Furniture,-212
11-01-2023 16:00,3150,1911,West,86,633,110,Clothing,1239
11-01-2023 17:00,4493,639,West,68,946,671,Clothing,3854
11-01-2023 18:00,4775,1040,South,85,617,843,Electronics,3735
11-01-2023 19:00,1763,1914,East,83,1766,846,Furniture,-151
11-01-2023 20:00,3785,769,North,56,1248,614,Clothing,3016
11-01-2023 21:00,3853,1535,South,94,1673,243,Furniture,2318
11-01-2023 22:00,2329,2390,East,69,1145,841,Groceries,-61
11-01-2023 23:00,3145,1005,West,61,878,620,Furniture,2140
12-01-2023 00:00,4921,1629,South,81,1107,908,Furniture,3292
12-01-2023 01:00,3845,2579,West,51,1465,393,Electronics,1266
12-01-2023 02:00,2358,2372,North,71,1024,424,Electronics,-14
12-01-2023 03:00,3906,1592,West,90,1640,292,Groceries,2314
12-01-2023 04:00,3482,1312,North,97,1075,390,Groceries,2170
12-01-2023 05:00,1446,861,West,89,1436,738,Furniture,585
12-01-2023 06:00,3017,1956,West,73,1161,518,Clothing,1061
12-01-2023 07:00,2331,1428,North,99,1840,559,Furniture,903
12-01-2023 08:00,1248,599,West,80,1375,147,Groceries,649
12-01-2023 09:00,1165,2181,East,53,511,206,Electronics,-1016
12-01-2023 10:00,4552,2556,West,73,1613,363,Electronics,1996
12-01-2023 11:00,4031,1552,South,92,887,352,Groceries,2479
12-01-2023 12:00,2358,1420,West,66,582,638,Furniture,938
12-01-2023 13:00,2019,2937,East,89,1475,620,Clothing,-918
12-01-2023 14:00,1541,1131,South,68,895,831,Electronics,410
12-01-2023 15:00,1758,1181,East,89,1044,257,Furniture,577
12-01-2023 16:00,4177,2704,South,87,1160,625,Clothing,1473
12-01-2023 17:00,4634,2882,West,83,1139,128,Groceries,1752
12-01-2023 18:00,3128,2807,East,96,599,637,Furniture,321
12-01-2023 19:00,3180,2629,West,82,956,825,Clothing,551
12-01-2023 20:00,1796,1253,South,55,1373,242,Furniture,543
12-01-2023 21:00,3947,1964,East,85,827,726,Electronics,1983
12-01-2023 22:00,1137,1219,North,62,1223,940,Groceries,-82
12-01-2023 23:00,3231,574,East,96,573,317,Electronics,2657
13-01-2023 00:00,4472,1793,West,58,1619,692,Electronics,2679
13-01-2023 01:00,2353,2422,North,84,591,812,Furniture,-69
13-01-2023 02:00,3832,561,North,83,829,166,Groceries,3271
13-01-2023 03:00,4579,1373,South,65,674,860,Furniture,3206
13-01-2023 04:00,2875,819,North,67,814,243,Clothing,2056
13-01-2023 05:00,4031,2649,North,67,996,240,Groceries,1382
13-01-2023 06:00,1068,1952,South,87,1792,445,Electronics,-884
13-01-2023 07:00,3593,1373,East,99,927,564,Electronics,2220
13-01-2023 08:00,4845,2245,West,92,534,195,Electronics,2600
13-01-2023 09:00,3100,2802,East,81,618,507,Furniture,298
13-01-2023 10:00,2473,2055,North,56,1894,217,Furniture,418
13-01-2023 11:00,1204,611,West,72,1424,929,Furniture,593
13-01-2023 12:00,3173,960,East,72,1974,796,Groceries,2213
13-01-2023 13:00,4818,1386,West,95,1832,903,Groceries,3432
13-01-2023 14:00,1042,1615,North,67,1880,543,Groceries,-573
13-01-2023 15:00,4823,1575,East,56,1899,856,Groceries,3248
13-01-2023 16:00,2906,1019,West,91,1327,479,Clothing,1887
13-01-2023 17:00,3158,1311,West,89,1628,812,Electronics,1847
13-01-2023 18:00,1760,2783,East,73,889,377,Furniture,-1023
13-01-2023 19:00,4734,2424,East,63,675,460,Furniture,2310
13-01-2023 20:00,4254,2104,North,99,605,469,Clothing,2150
13-01-2023 21:00,3895,1426,South,54,1091,721,Electronics,2469
13-01-2023 22:00,3142,1056,West,95,1686,311,Electronics,2086
13-01-2023 23:00,2994,2781,East,71,1413,358,Clothing,213
14-01-2023 00:00,4445,1555,East,71,1790,775,Groceries,2890
14-01-2023 01:00,2935,1078,East,59,1802,196,Electronics,1857
14-01-2023 02:00,4591,1041,West,75,1826,309,Groceries,3550
14-01-2023 03:00,1899,2661,North,64,1454,647,Clothing,-762
14-01-2023 04:00,1359,2751,South,87,1452,877,Furniture,-1392
14-01-2023 05:00,3947,1552,West,90,1360,711,Furniture,2395
14-01-2023 06:00,2719,973,North,91,626,120,Furniture,1746
14-01-2023 07:00,1280,2800,West,98,1769,828,Furniture,-1520
14-01-2023 08:00,4266,1404,West,50,1323,532,Electronics,2862
14-01-2023 09:00,2887,2445,East,63,733,715,Groceries,442
14-01-2023 10:00,4266,885,North,85,1166,470,Furniture,3381
14-01-2023 11:00,1666,561,East,80,1430,492,Furniture,1105
14-01-2023 12:00,1092,1014,East,77,1962,723,Furniture,78
14-01-2023 13:00,1671,929,North,83,636,318,Clothing,742
14-01-2023 14:00,2969,1079,East,84,1055,603,Electronics,1890
14-01-2023 15:00,1060,2060,East,88,1258,731,Clothing,-1000
14-01-2023 16:00,3681,1664,South,72,1672,860,Groceries,2017
14-01-2023 17:00,4122,1823,North,95,555,946,Furniture,2299
14-01-2023 18:00,4474,2858,North,93,855,195,Electronics,1616
14-01-2023 19:00,4860,970,East,68,1780,531,Electronics,3890
14-01-2023 20:00,2028,1916,East,67,1422,287,Electronics,112
14-01-2023 21:00,2489,2165,North,64,1312,600,Clothing,324
14-01-2023 22:00,1603,1968,North,50,1586,975,Clothing,-365
14-01-2023 23:00,1681,1308,West,74,1586,474,Clothing,373
15-01-2023 00:00,4900,671,North,75,1305,533,Clothing,4229
15-01-2023 01:00,3581,530,West,84,1552,522,Groceries,3051
15-01-2023 02:00,2428,546,East,64,1099,243,Furniture,1882
15-01-2023 03:00,3885,629,South,53,1067,639,Furniture,3256
15-01-2023 04:00,4584,2899,South,64,1823,598,Clothing,1685
15-01-2023 05:00,3692,1477,West,91,1204,105,Clothing,2215
15-01-2023 06:00,3280,2145,East,87,1111,416,Clothing,1135
15-01-2023 07:00,1523,2104,East,94,1738,873,Groceries,-581
15-01-2023 08:00,3393,557,East,88,640,329,Groceries,2836
15-01-2023 09:00,4117,1629,North,50,1060,221,Electronics,2488
15-01-2023 10:00,3593,1853,East,71,998,594,Furniture,1740
15-01-2023 11:00,2968,1267,North,60,1126,805,Clothing,1701
15-01-2023 12:00,2101,1182,West,95,1001,716,Electronics,919
15-01-2023 13:00,2753,2508,South,87,1240,810,Furniture,245
15-01-2023 14:00,2836,2833,West,86,1263,574,Electronics,3
15-01-2023 15:00,4994,2290,East,75,1714,673,Groceries,2704
15-01-2023 16:00,4144,1977,East,76,1174,895,Groceries,2167
15-01-2023 17:00,3841,1385,West,62,548,607,Electronics,2456
15-01-2023 18:00,3296,896,North,56,1886,691,Electronics,2400
15-01-2023 19:00,3094,2038,North,57,1126,274,Furniture,1056
15-01-2023 20:00,2144,2573,North,95,1179,620,Clothing,-429
15-01-2023 21:00,3261,812,South,72,776,791,Furniture,2449
15-01-2023 22:00,3286,2673,South,75,546,370,Furniture,613
15-01-2023 23:00,2079,2088,East,93,1425,773,Groceries,-9
16-01-2023 00:00,3397,1721,West,76,715,887,Groceries,1676
16-01-2023 01:00,1106,1310,West,58,729,817,Electronics,-204
16-01-2023 02:00,3878,2735,East,95,822,671,Groceries,1143
16-01-2023 03:00,1047,2532,North,87,1944,285,Furniture,-1485
16-01-2023 04:00,4644,2007,South,96,724,686,Electronics,2637
16-01-2023 05:00,1336,949,West,62,1810,193,Electronics,387
16-01-2023 06:00,2049,2394,East,56,545,678,Groceries,-345
16-01-2023 07:00,3851,1877,North,60,1537,613,Clothing,1974
16-01-2023 08:00,2280,1096,North,59,1132,277,Groceries,1184
16-01-2023 09:00,3055,2647,South,82,874,753,Electronics,408
16-01-2023 10:00,1624,1115,South,88,1202,655,Electronics,509
16-01-2023 11:00,2890,1447,East,99,1486,785,Clothing,1443
16-01-2023 12:00,2276,2081,East,52,832,394,Furniture,195
16-01-2023 13:00,2715,1055,North,90,665,330,Electronics,1660
16-01-2023 14:00,3766,777,North,78,1006,335,Clothing,2989
16-01-2023 15:00,1302,2513,West,86,616,192,Furniture,-1211
16-01-2023 16:00,1638,990,North,94,1442,586,Groceries,648
16-01-2023 17:00,1055,754,East,65,1135,143,Clothing,301
16-01-2023 18:00,1725,2928,South,65,1962,638,Furniture,-1203
16-01-2023 19:00,1525,1391,East,93,1827,883,Electronics,134
16-01-2023 20:00,1473,1041,West,99,956,574,Electronics,432
16-01-2023 21:00,1027,1787,West,92,1368,138,Clothing,-760
16-01-2023 22:00,3125,2133,South,98,1794,484,Groceries,992
16-01-2023 23:00,4287,1324,East,56,715,534,Clothing,2963
17-01-2023 00:00,4457,1852,West,64,612,388,Electronics,2605
17-01-2023 01:00,1364,780,East,87,1539,347,Furniture,584
17-01-2023 02:00,3713,1798,West,55,715,661,Groceries,1915
17-01-2023 03:00,1525,1272,South,67,926,458,Furniture,253
17-01-2023 04:00,3746,827,West,68,1658,537,Clothing,2919
17-01-2023 05:00,2335,2758,East,51,1566,894,Clothing,-423
17-01-2023 06:00,1882,1422,East,52,1263,308,Furniture,460
17-01-2023 07:00,2030,1051,West,95,783,223,Furniture,979
17-01-2023 08:00,2026,2573,North,74,1333,953,Furniture,-547
17-01-2023 09:00,2646,2574,South,85,1621,860,Clothing,72
17-01-2023 10:00,1918,1201,South,98,1583,502,Furniture,717
17-01-2023 11:00,3797,2419,West,77,729,383,Electronics,1378
17-01-2023 12:00,3410,2960,West,87,884,762,Furniture,450
17-01-2023 13:00,2774,666,North,77,658,675,Electronics,2108
17-01-2023 14:00,2531,668,South,81,1323,340,Electronics,1863
17-01-2023 15:00,4345,728,North,90,970,266,Furniture,3617
17-01-2023 16:00,4577,2502,South,85,707,851,Groceries,2075
17-01-2023 17:00,3853,866,West,88,673,660,Groceries,2987
17-01-2023 18:00,3786,1027,South,85,1604,798,Groceries,2759
17-01-2023 19:00,2906,1290,South,92,1541,247,Electronics,1616
17-01-2023 20:00,4086,1023,South,72,1516,800,Groceries,3063
17-01-2023 21:00,2215,1595,North,51,1207,722,Groceries,620
17-01-2023 22:00,2654,2168,North,59,1814,995,Furniture,486
17-01-2023 23:00,1484,2653,South,55,1883,364,Clothing,-1169
18-01-2023 00:00,3075,2408,East,57,1802,600,Electronics,667
18-01-2023 01:00,1713,1805,North,64,1474,378,Clothing,-92
18-01-2023 02:00,2062,632,West,94,896,848,Electronics,1430
18-01-2023 03:00,2976,2816,West,78,1473,258,Electronics,160
18-01-2023 04:00,2296,2142,South,77,1265,159,Groceries,154
18-01-2023 05:00,2254,2388,West,71,1665,598,Furniture,-134
18-01-2023 06:00,3133,2270,North,83,1176,416,Clothing,863
18-01-2023 07:00,4545,517,East,69,1016,686,Clothing,4028
18-01-2023 08:00,1125,2277,East,82,1774,587,Groceries,-1152
18-01-2023 09:00,3859,616,East,64,1161,564,Clothing,3243
18-01-2023 10:00,1536,1297,West,56,1760,327,Clothing,239
18-01-2023 11:00,3192,2211,South,73,1655,765,Electronics,981
18-01-2023 12:00,4596,1252,West,75,805,455,Furniture,3344
18-01-2023 13:00,4283,2969,South,99,857,565,Furniture,1314
18-01-2023 14:00,3072,1892,East,59,1808,921,Clothing,1180
18-01-2023 15:00,2603,2597,North,64,1816,898,Clothing,6
18-01-2023 16:00,4465,1177,West,86,1686,852,Electronics,3288
18-01-2023 17:00,1066,605,North,73,918,326,Groceries,461
18-01-2023 18:00,1232,1157,East,60,1991,268,Electronics,75
18-01-2023 19:00,3156,2446,South,89,1141,383,Groceries,710
18-01-2023 20:00,2169,1948,North,70,1006,957,Groceries,221
18-01-2023 21:00,3158,1595,West,89,1885,361,Electronics,1563
18-01-2023 22:00,3275,1487,North,87,811,901,Furniture,1788
18-01-2023 23:00,1110,2308,North,64,1203,959,Electronics,-1198
19-01-2023 00:00,2493,2282,West,64,744,463,Groceries,211
19-01-2023 01:00,3081,945,South,86,976,620,Furniture,2136
19-01-2023 02:00,1622,2448,West,94,1114,960,Furniture,-826
19-01-2023 03:00,4847,2617,East,63,935,197,Electronics,2230
19-01-2023 04:00,4440,2497,South,92,749,111,Furniture,1943
19-01-2023 05:00,3795,2697,North,70,1545,883,Furniture,1098
19-01-2023 06:00,3642,1273,West,93,976,682,Electronics,2369
19-01-2023 07:00,4625,2061,East,69,1010,516,Clothing,2564
19-01-2023 08:00,3472,2175,West,82,1859,600,Furniture,1297
19-01-2023 09:00,3660,1622,South,52,1273,234,Electronics,2038
19-01-2023 10:00,2541,1801,East,89,1865,358,Electronics,740
19-01-2023 11:00,3739,2086,North,72,1861,616,Clothing,1653
19-01-2023 12:00,2305,2186,South,93,1423,850,Furniture,119
19-01-2023 13:00,4391,1443,East,96,1565,393,Groceries,2948
19-01-2023 14:00,2761,954,South,72,573,946,Groceries,1807
19-01-2023 15:00,4514,1627,North,76,1308,710,Furniture,2887
19-01-2023 16:00,2975,1445,East,84,1330,539,Furniture,1530
19-01-2023 17:00,3362,1100,West,74,1545,250,Electronics,2262
19-01-2023 18:00,1876,1224,West,81,719,580,Electronics,652
19-01-2023 19:00,2989,2780,North,71,578,357,Groceries,209
19-01-2023 20:00,4812,1917,East,57,734,967,Furniture,2895
19-01-2023 21:00,4448,2024,North,87,656,248,Electronics,2424
19-01-2023 22:00,2312,750,North,67,826,241,Groceries,1562
19-01-2023 23:00,2460,2044,South,77,1637,350,Groceries,416
20-01-2023 00:00,3709,578,West,77,1141,845,Clothing,3131
20-01-2023 01:00,3324,1397,North,60,1120,743,Furniture,1927
20-01-2023 02:00,2733,1280,South,61,1484,146,Clothing,1453
20-01-2023 03:00,2605,725,North,51,1798,471,Electronics,1880
20-01-2023 04:00,2526,1574,North,86,1904,193,Electronics,952
20-01-2023 05:00,3671,1709,North,53,1543,860,Groceries,1962
20-01-2023 06:00,3563,1557,West,90,1732,455,Electronics,2006
20-01-2023 07:00,4421,1302,East,94,1105,631,Clothing,3119
20-01-2023 08:00,3890,1241,West,94,1363,791,Furniture,2649
20-01-2023 09:00,4517,2678,South,96,1248,371,Groceries,1839
20-01-2023 10:00,4901,1203,East,83,1683,528,Groceries,3698
20-01-2023 11:00,3397,1926,South,72,1414,747,Electronics,1471
20-01-2023 12:00,2630,2870,North,62,1398,848,Groceries,-240
20-01-2023 13:00,4735,1114,East,56,1497,801,Groceries,3621
20-01-2023 14:00,3870,828,South,81,1359,823,Furniture,3042
20-01-2023 15:00,2160,1895,North,72,1072,163,Groceries,265
20-01-2023 16:00,1758,1983,South,98,537,971,Furniture,-225
20-01-2023 17:00,3946,632,South,57,617,263,Clothing,3314
20-01-2023 18:00,1242,1334,West,99,889,488,Groceries,-92
20-01-2023 19:00,3590,620,North,96,1179,568,Clothing,2970
20-01-2023 20:00,2063,1975,West,96,876,649,Furniture,88
20-01-2023 21:00,1228,1464,East,86,1348,826,Groceries,-236
20-01-2023 22:00,3595,628,North,83,875,630,Electronics,2967
20-01-2023 23:00,1919,2098,West,97,1094,865,Electronics,-179
21-01-2023 00:00,2246,2576,West,78,1246,685,Groceries,-330
21-01-2023 01:00,1005,2047,East,86,1565,752,Furniture,-1042
21-01-2023 02:00,4393,832,South,72,1993,116,Electronics,3561
21-01-2023 03:00,1467,1653,South,87,957,706,Clothing,-186
21-01-2023 04:00,2755,1816,South,78,1653,845,Furniture,939
21-01-2023 05:00,1074,1696,East,93,1551,400,Furniture,-622
21-01-2023 06:00,1003,1929,West,54,1240,187,Groceries,-926
21-01-2023 07:00,2870,855,North,89,1128,909,Clothing,2015
21-01-2023 08:00,1645,638,East,60,825,662,Furniture,1007
21-01-2023 09:00,1117,2026,South,63,1118,344,Groceries,-909
21-01-2023 10:00,3928,1697,South,98,824,566,Clothing,2231
21-01-2023 11:00,2629,528,North,91,1683,541,Furniture,2101
21-01-2023 12:00,3551,1430,East,51,1015,212,Electronics,2121
21-01-2023 13:00,3021,1513,South,84,1245,541,Clothing,1508
21-01-2023 14:00,1946,1327,East,94,1777,107,Furniture,619
21-01-2023 15:00,3621,850,West,98,747,648,Clothing,2771
21-01-2023 16:00,2464,2524,East,84,1876,658,Electronics,-60
21-01-2023 17:00,1193,798,West,91,897,199,Furniture,395
21-01-2023 18:00,1846,2243,North,77,1081,444,Electronics,-397
21-01-2023 19:00,3762,2365,West,57,702,784,Groceries,1397
21-01-2023 20:00,2415,1715,West,81,1825,852,Groceries,700
21-01-2023 21:00,4097,2195,North,53,1671,580,Furniture,1902
21-01-2023 22:00,2458,2611,South,94,720,802,Furniture,-153
21-01-2023 23:00,3220,1254,North,56,1366,441,Clothing,1966
22-01-2023 00:00,4371,1269,East,88,762,333,Furniture,3102
22-01-2023 01:00,2668,1738,North,97,795,892,Groceries,930
22-01-2023 02:00,3373,1333,East,76,1838,334,Furniture,2040
22-01-2023 03:00,2433,2713,South,86,1519,225,Clothing,-280
22-01-2023 04:00,2141,2406,East,66,791,789,Groceries,-265
22-01-2023 05:00,3883,2064,North,59,1183,576,Furniture,1819
22-01-2023 06:00,2810,1718,North,53,1375,784,Electronics,1092
22-01-2023 07:00,1723,1005,South,72,1554,471,Electronics,718
22-01-2023 08:00,1224,1857,North,63,1567,219,Electronics,-633
22-01-2023 09:00,1531,1960,South,54,1054,641,Electronics,-429
22-01-2023 10:00,1112,1916,South,51,1657,659,Clothing,-804
22-01-2023 11:00,3187,1672,North,95,848,278,Electronics,1515
22-01-2023 12:00,1558,1260,West,73,718,193,Electronics,298
22-01-2023 13:00,3048,1332,East,67,1522,666,Furniture,1716
22-01-2023 14:00,3137,1928,West,76,949,847,Electronics,1209
22-01-2023 15:00,1653,782,South,73,1003,401,Electronics,871
22-01-2023 16:00,1319,878,East,78,585,898,Furniture,441
22-01-2023 17:00,2573,697,West,60,1774,517,Groceries,1876
22-01-2023 18:00,2828,1055,North,97,1788,959,Clothing,1773
22-01-2023 19:00,2917,855,West,67,1022,685,Clothing,2062
22-01-2023 20:00,1138,2063,East,97,1603,551,Groceries,-925
22-01-2023 21:00,4582,1540,East,53,960,516,Furniture,3042
22-01-2023 22:00,4939,878,East,82,1513,923,Groceries,4061
22-01-2023 23:00,3892,1179,East,63,1129,221,Clothing,2713
23-01-2023 00:00,3026,2279,West,93,751,156,Clothing,747
23-01-2023 01:00,3306,1398,North,91,517,884,Groceries,1908
23-01-2023 02:00,4744,575,North,81,1779,238,Electronics,4169
23-01-2023 03:00,1901,730,East,53,1768,298,Clothing,1171
23-01-2023 04:00,1689,2239,North,69,1676,820,Groceries,-550
23-01-2023 05:00,3039,1461,West,70,999,884,Electronics,1578
23-01-2023 06:00,1009,2849,North,52,957,460,Electronics,-1840
23-01-2023 07:00,1260,2762,South,74,614,749,Furniture,-1502
23-01-2023 08:00,2942,2616,North,53,1252,509,Groceries,326
23-01-2023 09:00,2673,892,East,96,1268,745,Clothing,1781
23-01-2023 10:00,3219,1608,North,60,946,948,Furniture,1611
23-01-2023 11:00,3945,766,North,65,852,627,Clothing,3179
23-01-2023 12:00,3060,1592,North,85,1124,714,Electronics,1468
23-01-2023 13:00,2191,1110,North,55,1040,342,Groceries,1081
23-01-2023 14:00,4713,1870,South,80,821,189,Electronics,2843
23-01-2023 15:00,2619,1508,West,89,1982,615,Electronics,1111
23-01-2023 16:00,1320,1461,East,62,725,161,Electronics,-141
23-01-2023 17:00,2342,1172,East,72,860,311,Groceries,1170
23-01-2023 18:00,2636,2970,North,53,1333,347,Furniture,-334
23-01-2023 19:00,3376,2200,West,86,611,803,Clothing,1176
23-01-2023 20:00,3832,2662,North,91,711,596,Electronics,1170
23-01-2023 21:00,3824,2767,South,86,1756,155,Clothing,1057
23-01-2023 22:00,2994,530,West,93,1447,558,Clothing,2464
23-01-2023 23:00,3958,1866,West,82,658,388,Furniture,2092
24-01-2023 00:00,2943,1900,West,91,1071,642,Groceries,1043
24-01-2023 01:00,4621,1653,West,78,1847,569,Clothing,2968
24-01-2023 02:00,3038,1116,North,86,1616,488,Furniture,1922
24-01-2023 03:00,4490,1038,South,68,1771,520,Clothing,3452
24-01-2023 04:00,4677,1370,West,69,1169,612,Electronics,3307
24-01-2023 05:00,2118,600,East,81,1664,809,Furniture,1518
24-01-2023 06:00,4888,1912,East,93,1410,656,Groceries,2976
24-01-2023 07:00,2604,1440,South,65,1522,658,Groceries,1164
24-01-2023 08:00,3365,840,East,54,903,833,Electronics,2525
24-01-2023 09:00,1235,1543,North,98,903,897,Electronics,-308
24-01-2023 10:00,2969,537,North,95,1100,180,Clothing,2432
24-01-2023 11:00,1333,1159,South,61,1937,543,Furniture,174
24-01-2023 12:00,2908,2533,West,94,1963,891,Furniture,375
24-01-2023 13:00,1375,2060,East,70,1756,386,Furniture,-685
24-01-2023 14:00,4530,2156,East,63,692,383,Furniture,2374
24-01-2023 15:00,2160,1549,South,86,1622,590,Clothing,611
24-01-2023 16:00,3635,953,South,71,1636,487,Furniture,2682
24-01-2023 17:00,2570,2204,East,79,1804,800,Furniture,366
24-01-2023 18:00,3560,1846,West,72,1499,650,Groceries,1714
24-01-2023 19:00,2319,1318,South,54,1022,694,Groceries,1001
24-01-2023 20:00,4391,1272,North,78,849,507,Clothing,3119
24-01-2023 21:00,3965,512,East,79,815,426,Electronics,3453
24-01-2023 22:00,4643,1420,South,67,1442,275,Groceries,3223
24-01-2023 23:00,2855,1324,South,95,1412,620,Electronics,1531
25-01-2023 00:00,2372,2918,South,99,1151,889,Clothing,-546
25-01-2023 01:00,4911,1814,East,50,1134,482,Groceries,3097
25-01-2023 02:00,4850,2879,North,88,1510,357,Groceries,1971
25-01-2023 03:00,1872,2808,North,66,1959,446,Clothing,-936
25-01-2023 04:00,2252,2517,East,52,1092,371,Furniture,-265
25-01-2023 05:00,3317,1728,South,91,943,360,Clothing,1589
25-01-2023 06:00,2851,1196,East,56,1120,495,Electronics,1655
25-01-2023 07:00,3845,1449,East,76,1731,791,Electronics,2396
25-01-2023 08:00,2314,2934,South,77,1255,253,Furniture,-620
25-01-2023 09:00,1724,1938,East,93,1799,626,Clothing,-214
25-01-2023 10:00,4236,568,West,80,996,166,Clothing,3668
25-01-2023 11:00,3052,2281,North,64,1272,940,Furniture,771
25-01-2023 12:00,3898,2747,West,97,1820,798,Clothing,1151
25-01-2023 13:00,4450,2763,West,57,873,447,Groceries,1687
25-01-2023 14:00,1077,2469,West,55,683,162,Clothing,-1392
25-01-2023 15:00,4481,711,East,77,531,455,Groceries,3770
25-01-2023 16:00,3621,1007,South,53,782,380,Clothing,2614
25-01-2023 17:00,1131,2563,East,79,1335,140,Groceries,-1432
25-01-2023 18:00,1600,2021,North,92,1372,639,Electronics,-421
25-01-2023 19:00,2772,831,East,66,1955,466,Furniture,1941
25-01-2023 20:00,2065,1050,East,83,1185,376,Electronics,1015
25-01-2023 21:00,3136,2124,East,55,961,320,Groceries,1012
25-01-2023 22:00,3449,1441,East,85,1370,828,Furniture,2008
25-01-2023 23:00,3343,2803,West,84,1483,833,Electronics,540
26-01-2023 00:00,2863,1227,South,88,867,160,Electronics,1636
26-01-2023 01:00,2318,1379,North,88,1157,202,Groceries,939
26-01-2023 02:00,1615,1148,North,65,1775,284,Clothing,467
26-01-2023 03:00,4597,1499,North,51,665,246,Clothing,3098
26-01-2023 04:00,3847,2021,East,57,1499,174,Groceries,1826
26-01-2023 05:00,4762,2112,North,64,1101,572,Electronics,2650
26-01-2023 06:00,4708,1509,West,76,1894,100,Clothing,3199
26-01-2023 07:00,3469,2050,South,65,1626,515,Clothing,1419
26-01-2023 08:00,2888,1303,East,50,1093,568,Electronics,1585
26-01-2023 09:00,2046,713,East,59,625,464,Groceries,1333
26-01-2023 10:00,1574,668,West,56,537,944,Groceries,906
26-01-2023 11:00,3190,1477,North,97,847,773,Clothing,1713
26-01-2023 12:00,1992,1828,East,59,1736,116,Groceries,164
26-01-2023 13:00,3712,645,East,61,1842,609,Electronics,3067
26-01-2023 14:00,3192,2298,West,66,1236,854,Groceries,894
26-01-2023 15:00,2248,1015,West,94,1233,538,Furniture,1233
26-01-2023 16:00,4054,952,North,61,925,978,Groceries,3102
26-01-2023 17:00,1502,559,South,64,1770,630,Groceries,943
26-01-2023 18:00,2997,1027,South,95,1147,941,Groceries,1970
26-01-2023 19:00,1820,1523,North,81,785,158,Furniture,297
26-01-2023 20:00,4687,2064,South,81,1754,812,Electronics,2623
26-01-2023 21:00,3151,1602,West,75,819,214,Groceries,1549
26-01-2023 22:00,4110,932,West,63,1011,302,Clothing,3178
26-01-2023 23:00,2970,1676,West,99,724,905,Groceries,1294
27-01-2023 00:00,1197,900,South,75,1005,642,Furniture,297
27-01-2023 01:00,2669,2604,South,54,1630,293,Furniture,65
27-01-2023 02:00,3626,2733,East,87,1241,571,Clothing,893
27-01-2023 03:00,3438,2945,East,99,1854,205,Furniture,493
27-01-2023 04:00,2202,1104,East,95,1528,978,Furniture,1098
27-01-2023 05:00,3601,2705,South,53,967,917,Furniture,896
27-01-2023 06:00,2471,2310,East,77,1437,225,Electronics,161
27-01-2023 07:00,4571,1963,West,50,1264,513,Furniture,2608
27-01-2023 08:00,4086,2993,South,62,662,714,Groceries,1093
27-01-2023 09:00,2646,2273,North,92,1152,774,Clothing,373
27-01-2023 10:00,2692,2053,South,52,1400,609,Groceries,639
27-01-2023 11:00,2312,1596,East,98,1307,600,Groceries,716
27-01-2023 12:00,3035,1428,South,99,581,926,Clothing,1607
27-01-2023 13:00,1477,2451,East,74,980,220,Electronics,-974
27-01-2023 14:00,2254,2473,East,91,1015,851,Electronics,-219
27-01-2023 15:00,1922,2564,North,65,686,706,Furniture,-642
27-01-2023 16:00,1419,2054,North,70,645,307,Electronics,-635
27-01-2023 17:00,3204,825,West,62,1505,760,Electronics,2379
27-01-2023 18:00,3597,1494,East,93,651,449,Furniture,2103
27-01-2023 19:00,4512,1112,South,85,1886,919,Electronics,3400
27-01-2023 20:00,2120,1095,North,57,592,292,Electronics,1025
27-01-2023 21:00,4068,1420,North,93,1554,753,Furniture,2648
27-01-2023 22:00,4044,1341,East,68,1039,883,Groceries,2703
27-01-2023 23:00,4482,1725,South,96,1148,922,Groceries,2757
28-01-2023 00:00,1950,843,North,65,1101,492,Clothing,1107
28-01-2023 01:00,3336,2376,North,61,548,596,Electronics,960
28-01-2023 02:00,2277,1358,South,69,1781,491,Furniture,919
28-01-2023 03:00,3243,1923,North,67,1040,812,Furniture,1320
28-01-2023 04:00,3645,944,South,61,1933,773,Electronics,2701
28-01-2023 05:00,2857,2288,East,97,655,208,Electronics,569
28-01-2023 06:00,4593,721,North,74,1274,569,Furniture,3872
28-01-2023 07:00,1516,1091,East,60,1045,449,Furniture,425
28-01-2023 08:00,2658,1530,South,71,1963,874,Furniture,1128
28-01-2023 09:00,2865,1795,East,95,1760,821,Clothing,1070
28-01-2023 10:00,3912,1517,East,83,1149,248,Groceries,2395
28-01-2023 11:00,2141,2563,East,62,1891,355,Furniture,-422
28-01-2023 12:00,3853,1947,West,95,1500,488,Groceries,1906
28-01-2023 13:00,2932,2545,South,87,1580,298,Electronics,387
28-01-2023 14:00,4230,1023,South,61,674,542,Groceries,3207
28-01-2023 15:00,1814,2568,South,88,1737,948,Groceries,-754
28-01-2023 16:00,3275,2775,South,85,526,285,Groceries,500
28-01-2023 17:00,2900,2308,South,77,1642,443,Electronics,592
28-01-2023 18:00,3263,1811,North,76,646,776,Groceries,1452
28-01-2023 19:00,3995,1806,North,88,1367,207,Groceries,2189
28-01-2023 20:00,4767,2951,North,62,764,694,Clothing,1816
28-01-2023 21:00,3062,1589,East,92,1926,912,Electronics,1473
28-01-2023 22:00,4228,2172,East,89,757,179,Groceries,2056
28-01-2023 23:00,4719,936,South,76,1712,352,Electronics,3783
29-01-2023 00:00,4332,1328,West,80,1326,124,Furniture,3004
29-01-2023 01:00,4228,758,South,51,1242,382,Groceries,3470
29-01-2023 02:00,3094,2503,North,67,1209,662,Electronics,591
29-01-2023 03:00,3371,2489,South,75,1762,986,Groceries,882
29-01-2023 04:00,3891,602,East,91,1850,719,Groceries,3289
29-01-2023 05:00,4756,1492,South,80,1593,337,Furniture,3264
29-01-2023 06:00,1129,1268,North,87,1548,415,Clothing,-139
29-01-2023 07:00,4482,1624,South,71,1679,939,Electronics,2858
29-01-2023 08:00,1094,1721,East,85,718,562,Groceries,-627
29-01-2023 09:00,3674,2773,West,68,1060,797,Furniture,901
29-01-2023 10:00,3802,736,North,63,1902,691,Furniture,3066
29-01-2023 11:00,2955,1644,South,63,1391,939,Clothing,1311
29-01-2023 12:00,4363,1266,East,99,1717,707,Clothing,3097
29-01-2023 13:00,1793,1490,North,78,1563,481,Furniture,303
29-01-2023 14:00,2834,2259,North,66,1096,564,Furniture,575
29-01-2023 15:00,4354,2820,East,99,842,249,Electronics,1534
29-01-2023 16:00,3116,2779,South,99,1002,451,Electronics,337
29-01-2023 17:00,2683,995,South,86,949,541,Furniture,1688
29-01-2023 18:00,1010,1547,South,58,835,494,Furniture,-537
29-01-2023 19:00,4325,2226,North,50,503,464,Clothing,2099
29-01-2023 20:00,2865,2572,West,53,1258,105,Electronics,293
29-01-2023 21:00,3919,2835,North,56,1016,633,Furniture,1084
29-01-2023 22:00,3597,837,South,60,1749,319,Electronics,2760
29-01-2023 23:00,4205,2437,North,63,1673,970,Electronics,1768
30-01-2023 00:00,1711,2317,West,91,737,111,Furniture,-606
30-01-2023 01:00,3070,636,North,68,602,894,Furniture,2434
30-01-2023 02:00,1814,2774,East,89,1698,484,Groceries,-960
30-01-2023 03:00,1345,819,South,52,1509,803,Electronics,526
30-01-2023 04:00,3349,2363,South,57,1984,557,Electronics,986
30-01-2023 05:00,1362,1415,South,78,1557,324,Clothing,-53
30-01-2023 06:00,3443,1705,North,99,1017,435,Clothing,1738
30-01-2023 07:00,3265,2397,North,86,939,266,Clothing,868
30-01-2023 08:00,3188,2633,North,92,1808,415,Electronics,555
30-01-2023 09:00,4687,1425,South,58,724,215,Furniture,3262
30-01-2023 10:00,4005,2600,North,68,1064,937,Furniture,1405
30-01-2023 11:00,4281,1758,South,61,1780,597,Furniture,2523
30-01-2023 12:00,1984,2482,North,76,1582,247,Electronics,-498
30-01-2023 13:00,4040,932,South,86,745,135,Furniture,3108
30-01-2023 14:00,4694,1498,East,97,1737,506,Clothing,3196
30-01-2023 15:00,2639,2647,North,74,1427,484,Furniture,-8
30-01-2023 16:00,1827,1489,South,94,1452,856,Furniture,338
30-01-2023 17:00,3730,1098,East,87,1318,510,Clothing,2632
30-01-2023 18:00,4531,2950,East,97,715,407,Groceries,1581
30-01-2023 19:00,4051,895,West,99,1926,741,Groceries,3156
30-01-2023 20:00,1355,914,North,66,782,339,Groceries,441
30-01-2023 21:00,4055,1438,South,93,1072,466,Electronics,2617
30-01-2023 22:00,2347,2136,West,82,1738,955,Electronics,211
30-01-2023 23:00,4204,1040,North,88,881,403,Clothing,3164
31-01-2023 00:00,3935,2149,East,63,1568,716,Groceries,1786
31-01-2023 01:00,4876,2445,North,77,671,266,Electronics,2431
31-01-2023 02:00,2863,583,South,67,1744,653,Furniture,2280
31-01-2023 03:00,1126,770,East,82,1908,865,Groceries,356
31-01-2023 04:00,4177,2791,West,91,1618,961,Groceries,1386
31-01-2023 05:00,4056,887,North,64,543,400,Electronics,3169
31-01-2023 06:00,1603,713,North,60,727,997,Groceries,890
31-01-2023 07:00,4870,558,West,85,1073,304,Clothing,4312
31-01-2023 08:00,4449,2125,North,64,816,294,Clothing,2324
31-01-2023 09:00,2928,1342,North,97,1230,270,Electronics,1586
31-01-2023 10:00,2013,2027,North,79,1858,861,Groceries,-14
31-01-2023 11:00,1050,2229,East,64,1100,715,Clothing,-1179
31-01-2023 12:00,4100,622,East,98,1123,974,Groceries,3478
31-01-2023 13:00,4533,1936,South,72,966,501,Clothing,2597
31-01-2023 14:00,4367,1662,North,92,796,138,Clothing,2705
31-01-2023 15:00,4368,2986,South,99,1044,847,Groceries,1382
31-01-2023 16:00,4797,1061,East,97,988,745,Electronics,3736
31-01-2023 17:00,3826,2665,North,64,1519,351,Electronics,1161
31-01-2023 18:00,2430,2237,South,78,714,781,Electronics,193
31-01-2023 19:00,2792,1404,North,60,1525,382,Groceries,1388
31-01-2023 20:00,3861,894,North,94,1160,306,Groceries,2967
31-01-2023 21:00,2636,2226,West,67,1153,599,Groceries,410
31-01-2023 22:00,4476,2216,South,89,1301,242,Electronics,2260
31-01-2023 23:00,4417,1434,East,80,1730,118,Groceries,2983
01-02-2023 00:00,2645,1601,South,58,840,801,Electronics,1044
01-02-2023 01:00,3467,1935,South,71,1203,675,Clothing,1532
01-02-2023 02:00,2205,574,South,60,906,841,Electronics,1631
01-02-2023 03:00,4030,794,West,66,1352,918,Electronics,3236
01-02-2023 04:00,3872,520,North,82,805,786,Furniture,3352
01-02-2023 05:00,4072,1538,East,60,1992,924,Furniture,2534
01-02-2023 06:00,2854,1734,West,88,1373,119,Electronics,1120
01-02-2023 07:00,1566,1059,East,57,994,887,Furniture,507
01-02-2023 08:00,3418,1609,West,53,1784,949,Groceries,1809
01-02-2023 09:00,1935,1672,North,85,1077,547,Furniture,263
01-02-2023 10:00,2934,871,East,68,1887,325,Furniture,2063
01-02-2023 11:00,3708,2527,South,73,1040,842,Furniture,1181
01-02-2023 12:00,4502,1317,West,90,1267,200,Electronics,3185
01-02-2023 13:00,4016,1674,East,98,1395,838,Clothing,2342
01-02-2023 14:00,2332,1664,North,67,954,393,Clothing,668
01-02-2023 15:00,4208,1592,East,82,1667,649,Clothing,2616
01-02-2023 16:00,1201,1783,West,95,1715,164,Clothing,-582
01-02-2023 17:00,4507,2511,North,85,1876,598,Clothing,1996
01-02-2023 18:00,3360,1345,South,59,798,175,Clothing,2015
01-02-2023 19:00,1116,2491,West,63,1983,803,Electronics,-1375
01-02-2023 20:00,4737,1020,West,56,926,734,Groceries,3717
01-02-2023 21:00,1936,870,North,61,1215,224,Groceries,1066
01-02-2023 22:00,4874,1942,West,71,1256,126,Clothing,2932
01-02-2023 23:00,1574,600,East,76,530,714,Furniture,974
02-02-2023 00:00,3291,1160,South,97,831,375,Furniture,2131
02-02-2023 01:00,1536,2181,East,86,1934,671,Electronics,-645
02-02-2023 02:00,2625,742,North,60,551,779,Clothing,1883
02-02-2023 03:00,3122,1011,West,85,1907,182,Clothing,2111
02-02-2023 04:00,4877,2773,South,62,742,585,Furniture,2104
02-02-2023 05:00,1385,2041,North,81,1274,562,Clothing,-656
02-02-2023 06:00,4974,2761,East,57,1185,105,Clothing,2213
02-02-2023 07:00,4281,2614,West,56,1940,775,Furniture,1667
02-02-2023 08:00,1474,895,West,92,1998,467,Groceries,579
02-02-2023 09:00,1417,1111,North,92,1915,570,Groceries,306
02-02-2023 10:00,3394,1760,East,66,1912,813,Electronics,1634
02-02-2023 11:00,4600,2357,West,71,1072,548,Furniture,2243
02-02-2023 12:00,3687,1269,East,95,1371,788,Electronics,2418
02-02-2023 13:00,1938,1922,South,83,1199,469,Clothing,16
02-02-2023 14:00,1954,906,West,69,1992,439,Furniture,1048
02-02-2023 15:00,1875,2372,South,57,1931,767,Groceries,-497
02-02-2023 16:00,1762,2003,West,71,1018,377,Clothing,-241
02-02-2023 17:00,2202,2769,North,76,1712,439,Groceries,-567
02-02-2023 18:00,2205,1679,West,83,1094,914,Groceries,526
02-02-2023 19:00,1663,1153,West,70,1874,713,Electronics,510
02-02-2023 20:00,1024,2975,East,64,782,179,Furniture,-1951
02-02-2023 21:00,2990,1681,East,54,1680,805,Furniture,1309
02-02-2023 22:00,2203,1476,South,87,1098,892,Furniture,727
02-02-2023 23:00,1709,1939,South,66,647,702,Electronics,-230
03-02-2023 00:00,4572,2918,South,57,569,166,Groceries,1654
03-02-2023 01:00,2879,1867,West,68,1893,314,Electronics,1012
03-02-2023 02:00,2184,728,West,54,733,515,Furniture,1456
03-02-2023 03:00,3224,2827,South,72,1178,244,Clothing,397
03-02-2023 04:00,1284,2393,North,68,1135,651,Furniture,-1109
03-02-2023 05:00,1062,1813,North,63,966,823,Furniture,-751
03-02-2023 06:00,2002,1570,West,59,1056,385,Groceries,432
03-02-2023 07:00,1661,1474,North,80,1393,670,Furniture,187
03-02-2023 08:00,3713,2238,North,62,1335,639,Furniture,1475
03-02-2023 09:00,3203,1257,South,71,1810,146,Groceries,1946
03-02-2023 10:00,4953,820,North,86,1117,336,Furniture,4133
03-02-2023 11:00,2492,2821,North,88,1817,216,Furniture,-329
03-02-2023 12:00,4120,1055,West,59,633,250,Groceries,3065
03-02-2023 13:00,1966,1343,West,80,507,182,Clothing,623
03-02-2023 14:00,1848,1836,West,92,527,156,Groceries,12
03-02-2023 15:00,2107,1886,North,84,1282,828,Furniture,221
03-02-2023 16:00,4432,1167,South,62,1833,484,Electronics,3265
03-02-2023 17:00,1688,2927,East,79,1040,319,Clothing,-1239
03-02-2023 18:00,1147,2442,West,83,1126,384,Groceries,-1295
03-02-2023 19:00,4701,2504,West,85,1557,853,Clothing,2197
03-02-2023 20:00,1341,2430,West,84,506,533,Clothing,-1089
03-02-2023 21:00,3523,1245,South,96,539,419,Electronics,2278
03-02-2023 22:00,2086,1174,East,53,1853,710,Electronics,912
03-02-2023 23:00,2724,2663,East,53,1408,341,Electronics,61
04-02-2023 00:00,2383,1565,West,96,561,564,Furniture,818
04-02-2023 01:00,3608,2926,North,55,1609,302,Groceries,682
04-02-2023 02:00,1326,2827,West,77,1639,648,Furniture,-1501
04-02-2023 03:00,2792,1117,West,79,1820,857,Groceries,1675
04-02-2023 04:00,2759,2665,North,76,878,544,Furniture,94
04-02-2023 05:00,4212,2856,North,54,821,739,Furniture,1356
04-02-2023 06:00,1989,2647,West,93,1232,234,Electronics,-658
04-02-2023 07:00,3262,2808,South,88,1918,957,Furniture,454
04-02-2023 08:00,3482,1492,South,84,1880,954,Electronics,1990
04-02-2023 09:00,4962,1828,North,88,1338,675,Groceries,3134
04-02-2023 10:00,1951,1877,West,93,918,885,Electronics,74
04-02-2023 11:00,1722,785,South,64,1859,640,Clothing,937
04-02-2023 12:00,4389,2875,West,68,519,586,Clothing,1514
04-02-2023 13:00,3079,2610,West,79,911,981,Furniture,469
04-02-2023 14:00,3717,1186,West,87,1048,837,Clothing,2531
04-02-2023 15:00,3332,1805,South,81,1782,671,Groceries,1527
04-02-2023 16:00,4376,1964,East,89,1104,585,Furniture,2412
04-02-2023 17:00,1428,1237,West,78,856,665,Electronics,191
04-02-2023 18:00,2500,2458,South,55,700,939,Furniture,42
04-02-2023 19:00,1285,2394,East,75,1934,760,Furniture,-1109
04-02-2023 20:00,4215,1985,North,76,1811,504,Clothing,2230
04-02-2023 21:00,4495,2600,South,84,1571,669,Furniture,1895
04-02-2023 22:00,4090,985,East,77,1264,532,Groceries,3105
04-02-2023 23:00,3065,2013,South,54,1893,647,Furniture,1052
05-02-2023 00:00,1768,2501,East,90,730,756,Electronics,-733
05-02-2023 01:00,3637,1887,East,97,1618,349,Electronics,1750
05-02-2023 02:00,2394,2956,South,65,802,179,Clothing,-562
05-02-2023 03:00,4246,1530,North,90,1741,114,Furniture,2716
05-02-2023 04:00,4057,2265,West,67,886,139,Electronics,1792
05-02-2023 05:00,1193,1167,East,62,1214,180,Furniture,26
05-02-2023 06:00,3549,1720,West,92,1424,609,Furniture,1829
05-02-2023 07:00,1987,1334,North,74,1614,406,Electronics,653
05-02-2023 08:00,2136,1375,West,59,557,804,Furniture,761
05-02-2023 09:00,3161,2914,West,78,933,496,Clothing,247
05-02-2023 10:00,4293,1501,South,59,1021,777,Clothing,2792
05-02-2023 11:00,2701,749,South,55,1267,964,Electronics,1952
05-02-2023 12:00,1946,2439,North,65,1328,303,Groceries,-493
05-02-2023 13:00,1830,2118,South,74,982,310,Groceries,-288
05-02-2023 14:00,4715,1763,East,93,866,498,Furniture,2952
05-02-2023 15:00,2920,2927,North,53,1388,472,Clothing,-7
05-02-2023 16:00,4335,1371,South,86,1930,488,Electronics,2964
05-02-2023 17:00,3972,1334,South,83,1854,357,Clothing,2638
05-02-2023 18:00,1054,1418,North,68,1758,214,Groceries,-364
05-02-2023 19:00,4942,2224,East,82,1382,433,Groceries,2718
05-02-2023 20:00,4714,2913,North,53,910,448,Furniture,1801
05-02-2023 21:00,1799,1813,South,93,682,332,Electronics,-14
05-02-2023 22:00,1777,2397,South,83,1810,608,Furniture,-620
05-02-2023 23:00,2481,902,North,61,1646,548,Clothing,1579
06-02-2023 00:00,2901,2605,East,80,657,176,Clothing,296
06-02-2023 01:00,3209,1827,East,65,1846,927,Groceries,1382
06-02-2023 02:00,4451,1638,West,51,512,707,Furniture,2813
06-02-2023 03:00,3134,709,East,98,1065,197,Clothing,2425
06-02-2023 04:00,1054,1564,North,51,1371,667,Clothing,-510
06-02-2023 05:00,4547,1315,East,85,1054,729,Clothing,3232
06-02-2023 06:00,2823,2720,East,55,1177,561,Electronics,103
06-02-2023 07:00,2201,733,West,72,1362,599,Groceries,1468
06-02-2023 08:00,4462,1292,East,88,1117,730,Furniture,3170
06-02-2023 09:00,4420,2407,West,96,703,137,Clothing,2013
06-02-2023 10:00,4079,2113,West,93,1456,796,Electronics,1966
06-02-2023 11:00,1832,2666,East,86,801,457,Clothing,-834
06-02-2023 12:00,1312,834,South,95,1566,341,Clothing,478
06-02-2023 13:00,3806,1859,North,65,1294,150,Groceries,1947
06-02-2023 14:00,2858,2139,North,92,1096,524,Electronics,719
06-02-2023 15:00,3007,1597,East,93,1228,226,Clothing,1410
06-02-2023 16:00,3006,1714,North,68,1005,202,Groceries,1292
06-02-2023 17:00,3490,823,North,98,1138,576,Electronics,2667
06-02-2023 18:00,2790,2290,West,73,690,328,Clothing,500
06-02-2023 19:00,1327,783,South,76,1398,822,Furniture,544
06-02-2023 20:00,4125,712,North,56,559,535,Groceries,3413
06-02-2023 21:00,3808,2158,South,79,1989,484,Clothing,1650
06-02-2023 22:00,4310,2241,North,90,1902,184,Clothing,2069
06-02-2023 23:00,4300,1428,South,63,1952,458,Electronics,2872
07-02-2023 00:00,3626,1251,South,93,561,885,Furniture,2375
07-02-2023 01:00,4122,1917,North,64,801,126,Groceries,2205
07-02-2023 02:00,4680,2886,West,61,1137,959,Electronics,1794
07-02-2023 03:00,4675,2321,South,78,1498,171,Clothing,2354
07-02-2023 04:00,4054,1545,South,72,671,194,Groceries,2509
07-02-2023 05:00,2287,2294,North,62,562,687,Clothing,-7
07-02-2023 06:00,4489,2392,South,58,1271,525,Clothing,2097
07-02-2023 07:00,4874,604,South,73,515,105,Furniture,4270
07-02-2023 08:00,3143,1989,West,88,1190,189,Clothing,1154
07-02-2023 09:00,2111,1982,South,79,1341,691,Groceries,129
07-02-2023 10:00,4149,1955,West,50,1624,321,Clothing,2194
07-02-2023 11:00,2311,1269,South,59,1699,694,Groceries,1042
07-02-2023 12:00,4191,2459,South,87,1716,693,Furniture,1732
07-02-2023 13:00,3861,2527,West,96,1398,251,Clothing,1334
07-02-2023 14:00,3538,878,West,64,1796,656,Electronics,2660
07-02-2023 15:00,4983,1212,East,58,1990,311,Groceries,3771
07-02-2023 16:00,1451,1872,South,62,1432,682,Clothing,-421
07-02-2023 17:00,2523,724,West,72,674,362,Electronics,1799
07-02-2023 18:00,1164,2237,South,82,1757,481,Groceries,-1073
07-02-2023 19:00,1181,1237,South,58,1739,669,Electronics,-56
07-02-2023 20:00,3516,735,South,52,916,156,Clothing,2781
07-02-2023 21:00,1909,682,North,79,950,525,Furniture,1227
07-02-2023 22:00,3782,1211,East,58,1335,722,Furniture,2571
07-02-2023 23:00,1822,2392,North,74,779,241,Electronics,-570
08-02-2023 00:00,1943,2991,East,96,743,667,Clothing,-1048
08-02-2023 01:00,3001,2388,South,73,1174,623,Clothing,613
08-02-2023 02:00,3054,1122,South,81,645,960,Groceries,1932
08-02-2023 03:00,1329,1759,West,56,1590,114,Clothing,-430
08-02-2023 04:00,1774,1650,East,85,602,107,Furniture,124
08-02-2023 05:00,4744,1248,East,74,809,330,Clothing,3496
08-02-2023 06:00,3198,2702,North,69,616,285,Groceries,496
08-02-2023 07:00,4156,2804,East,66,1995,152,Groceries,1352
08-02-2023 08:00,1146,2782,South,85,1262,236,Clothing,-1636
08-02-2023 09:00,4695,2836,West,75,1844,273,Clothing,1859
08-02-2023 10:00,4452,1009,North,68,1958,959,Groceries,3443
08-02-2023 11:00,1914,2075,West,86,1893,318,Groceries,-161
08-02-2023 12:00,2571,2323,East,97,1237,362,Electronics,248
08-02-2023 13:00,2308,1284,East,52,686,354,Furniture,1024
08-02-2023 14:00,3747,2845,North,92,1284,911,Furniture,902
08-02-2023 15:00,1081,636,East,77,1992,369,Electronics,445
08-02-2023 16:00,1513,2923,West,71,1206,686,Electronics,-1410
08-02-2023 17:00,2920,2634,South,96,1375,323,Furniture,286
08-02-2023 18:00,3862,2277,North,68,1295,982,Groceries,1585
08-02-2023 19:00,3756,1722,East,95,972,703,Furniture,2034
08-02-2023 20:00,2939,2984,West,65,1055,233,Groceries,-45
08-02-2023 21:00,4594,1833,South,55,1977,262,Furniture,2761
08-02-2023 22:00,1745,2277,East,86,1969,809,Groceries,-532
08-02-2023 23:00,4070,1804,North,80,1181,800,Furniture,2266
09-02-2023 00:00,2409,1263,East,98,593,172,Electronics,1146
09-02-2023 01:00,1706,1201,East,97,1235,997,Clothing,505
09-02-2023 02:00,1470,651,East,83,1289,817,Clothing,819
09-02-2023 03:00,4190,1825,South,80,537,642,Clothing,2365
09-02-2023 04:00,1395,1801,South,60,1281,993,Groceries,-406
09-02-2023 05:00,2555,2211,East,85,981,730,Clothing,344
09-02-2023 06:00,3308,1531,East,55,610,894,Furniture,1777
09-02-2023 07:00,1804,1306,North,76,909,583,Clothing,498
09-02-2023 08:00,1933,734,East,56,1691,977,Groceries,1199
09-02-2023 09:00,2279,1060,West,98,896,770,Groceries,1219
09-02-2023 10:00,2757,1825,West,81,1650,354,Groceries,932
09-02-2023 11:00,1904,537,North,57,541,856,Furniture,1367
09-02-2023 12:00,4297,1659,South,82,540,717,Groceries,2638
09-02-2023 13:00,2076,920,East,96,898,297,Furniture,1156
09-02-2023 14:00,3987,1742,North,93,681,526,Groceries,2245
09-02-2023 15:00,2890,847,South,64,1704,592,Electronics,2043
09-02-2023 16:00,2523,2331,North,76,1243,731,Groceries,192
09-02-2023 17:00,4577,2069,South,79,1217,181,Clothing,2508
09-02-2023 18:00,3901,2418,East,71,963,407,Clothing,1483
09-02-2023 19:00,2387,2820,North,96,1573,881,Electronics,-433
09-02-2023 20:00,2303,2401,East,78,1931,798,Groceries,-98
09-02-2023 21:00,1592,2855,North,90,1924,887,Clothing,-1263
09-02-2023 22:00,3761,1897,South,97,1669,473,Clothing,1864
09-02-2023 23:00,4229,2324,North,79,797,663,Furniture,1905
10-02-2023 00:00,3679,2991,West,51,644,558,Furniture,688
10-02-2023 01:00,3106,1728,West,64,515,600,Groceries,1378
10-02-2023 02:00,4798,904,North,96,1608,456,Electronics,3894
10-02-2023 03:00,1127,2221,West,76,1739,395,Groceries,-1094
10-02-2023 04:00,1735,1720,East,56,1575,679,Furniture,15
10-02-2023 05:00,3768,614,West,76,606,399,Furniture,3154
10-02-2023 06:00,4953,2176,West,70,718,745,Groceries,2777
10-02-2023 07:00,4186,564,East,62,1434,442,Groceries,3622
10-02-2023 08:00,4280,1799,East,66,836,219,Groceries,2481
10-02-2023 09:00,3573,1324,South,60,1420,668,Groceries,2249
10-02-2023 10:00,1520,2786,East,59,870,285,Electronics,-1266
10-02-2023 11:00,3599,2849,North,82,1497,683,Clothing,750
10-02-2023 12:00,1236,1915,West,63,1309,257,Groceries,-679
10-02-2023 13:00,2304,1468,South,86,753,327,Clothing,836
10-02-2023 14:00,4430,868,East,57,1928,407,Furniture,3562
10-02-2023 15:00,4272,732,West,82,1079,333,Clothing,3540
10-02-2023 16:00,2781,2742,North,56,1135,110,Groceries,39
10-02-2023 17:00,2301,1406,North,83,1553,274,Clothing,895
10-02-2023 18:00,4306,1420,South,56,684,872,Groceries,2886
10-02-2023 19:00,3541,1188,North,56,1812,742,Groceries,2353
10-02-2023 20:00,3051,676,West,90,1882,997,Furniture,2375
10-02-2023 21:00,3713,2764,East,85,973,101,Groceries,949
10-02-2023 22:00,1441,1534,North,56,1484,860,Furniture,-93
10-02-2023 23:00,3076,1969,East,69,1923,811,Electronics,1107
11-02-2023 00:00,4180,1129,West,67,1483,281,Groceries,3051
11-02-2023 01:00,3657,663,West,94,1656,449,Furniture,2994
11-02-2023 02:00,4798,2600,East,92,1001,738,Furniture,2198
11-02-2023 03:00,1804,2765,West,90,1373,481,Groceries,-961
11-02-2023 04:00,1074,1323,South,63,1600,396,Clothing,-249
11-02-2023 05:00,3885,2932,North,89,849,296,Furniture,953
11-02-2023 06:00,4217,555,South,63,559,385,Electronics,3662
11-02-2023 07:00,3175,617,South,70,1978,655,Clothing,2558
11-02-2023 08:00,4924,1297,South,98,1378,621,Clothing,3627
11-02-2023 09:00,3089,1279,East,76,964,324,Groceries,1810
11-02-2023 10:00,2379,1938,East,95,810,827,Furniture,441
11-02-2023 11:00,1040,2393,West,75,1614,822,Electronics,-1353
11-02-2023 12:00,3981,1207,East,76,1430,385,Furniture,2774
11-02-2023 13:00,3081,1603,West,73,1464,828,Electronics,1478
11-02-2023 14:00,4088,521,East,54,1821,430,Furniture,3567
11-02-2023 15:00,2700,2000,West,91,1848,660,Groceries,700
11-02-2023 16:00,4224,1342,North,87,779,262,Electronics,2882
11-02-2023 17:00,4045,2260,West,77,1210,292,Groceries,1785
11-02-2023 18:00,2401,1616,North,91,1466,244,Furniture,785
11-02-2023 19:00,1587,691,West,92,1641,770,Electronics,896
11-02-2023 20:00,2622,1518,East,81,1194,937,Electronics,1104
11-02-2023 21:00,4700,1626,East,73,1409,791,Furniture,3074
11-02-2023 22:00,4945,895,North,55,1066,637,Groceries,4050
11-02-2023 23:00,1341,1518,South,59,770,711,Electronics,-177
12-02-2023 00:00,3074,1066,South,95,1624,722,Electronics,2008
12-02-2023 01:00,4896,730,West,52,1911,369,Electronics,4166
12-02-2023 02:00,4358,1373,East,56,1809,150,Furniture,2985
12-02-2023 03:00,1645,739,South,78,1479,626,Clothing,906
12-02-2023 04:00,1730,589,East,83,1576,227,Furniture,1141
12-02-2023 05:00,1167,2779,East,56,1340,751,Groceries,-1612
12-02-2023 06:00,1609,956,East,66,1503,853,Clothing,653
12-02-2023 07:00,3315,2780,West,62,739,145,Electronics,535
12-02-2023 08:00,2772,853,North,70,1737,333,Electronics,1919
12-02-2023 09:00,3040,1504,West,80,860,547,Clothing,1536
12-02-2023 10:00,3868,1856,South,58,1887,683,Electronics,2012
12-02-2023 11:00,1454,938,North,94,1233,542,Electronics,516
12-02-2023 12:00,3953,1898,South,96,1351,602,Furniture,2055
12-02-2023 13:00,2708,844,North,62,1359,706,Furniture,1864
12-02-2023 14:00,4472,1156,North,66,1200,384,Groceries,3316
12-02-2023 15:00,3969,2677,West,57,1850,231,Electronics,1292
12-02-2023 16:00,4028,2688,East,58,1335,575,Groceries,1340
12-02-2023 17:00,4547,2962,East,58,1999,892,Groceries,1585
12-02-2023 18:00,1701,1616,North,89,1322,643,Clothing,85
12-02-2023 19:00,3681,1125,West,97,596,455,Clothing,2556
12-02-2023 20:00,4629,783,South,79,826,136,Electronics,3846
12-02-2023 21:00,2599,2479,South,56,572,737,Clothing,120
12-02-2023 22:00,1129,2178,East,66,1493,237,Groceries,-1049
12-02-2023 23:00,4067,722,East,88,1779,521,Furniture,3345
13-02-2023 00:00,2845,1243,South,87,1693,544,Clothing,1602
13-02-2023 01:00,2386,962,South,54,1493,711,Groceries,1424
13-02-2023 02:00,4776,2068,West,66,832,341,Clothing,2708
13-02-2023 03:00,3866,2205,South,89,1680,344,Electronics,1661
13-02-2023 04:00,1692,1663,West,50,1942,638,Clothing,29
13-02-2023 05:00,4363,2904,East,65,957,308,Furniture,1459
13-02-2023 06:00,2394,2236,South,66,1233,556,Electronics,158
13-02-2023 07:00,1793,1546,East,79,1375,198,Clothing,247
13-02-2023 08:00,1028,1164,North,80,1357,601,Furniture,-136
13-02-2023 09:00,1148,1856,North,84,598,236,Groceries,-708
13-02-2023 10:00,4850,1514,North,94,1231,286,Clothing,3336
13-02-2023 11:00,2319,2632,South,57,1424,135,Clothing,-313
13-02-2023 12:00,3058,1554,East,97,743,729,Groceries,1504
13-02-2023 13:00,4583,2264,South,79,1964,769,Groceries,2319
13-02-2023 14:00,3723,2787,East,88,1717,578,Clothing,936
13-02-2023 15:00,2136,2413,West,70,1898,886,Furniture,-277
13-02-2023 16:00,1186,862,South,64,1161,780,Groceries,324
13-02-2023 17:00,3854,1912,North,83,1505,154,Groceries,1942
13-02-2023 18:00,3791,1167,West,76,866,570,Furniture,2624
13-02-2023 19:00,2250,2380,East,51,1678,183,Clothing,-130
13-02-2023 20:00,2333,1894,South,59,998,105,Electronics,439
13-02-2023 21:00,1097,598,East,54,1981,990,Clothing,499
13-02-2023 22:00,1054,2594,East,76,612,462,Clothing,-1540
13-02-2023 23:00,3670,921,South,53,1444,955,Electronics,2749
14-02-2023 00:00,3711,2003,South,96,1547,867,Clothing,1708
14-02-2023 01:00,1757,561,East,62,782,809,Clothing,1196
14-02-2023 02:00,1405,1632,East,66,1815,763,Groceries,-227
14-02-2023 03:00,3116,2202,West,70,1886,929,Furniture,914
14-02-2023 04:00,4383,1097,North,72,900,269,Clothing,3286
14-02-2023 05:00,2312,891,East,82,1067,859,Electronics,1421
14-02-2023 06:00,2785,1575,North,99,1789,348,Electronics,1210
14-02-2023 07:00,4619,1812,West,64,1577,761,Groceries,2807
14-02-2023 08:00,1750,2529,North,63,1213,309,Clothing,-779
14-02-2023 09:00,4219,2884,North,58,921,839,Clothing,1335
14-02-2023 10:00,4538,1309,West,93,1348,343,Clothing,3229
14-02-2023 11:00,2762,1905,East,86,1997,240,Clothing,857
14-02-2023 12:00,4315,1659,North,79,1766,731,Electronics,2656
14-02-2023 13:00,4562,2031,East,78,1877,904,Electronics,2531
14-02-2023 14:00,4920,1885,East,72,1911,279,Groceries,3035
14-02-2023 15:00,4005,1380,South,83,1701,736,Clothing,2625
14-02-2023 16:00,4578,2099,East,56,974,853,Electronics,2479
14-02-2023 17:00,1364,753,East,58,904,823,Clothing,611
14-02-2023 18:00,3026,2567,North,99,535,116,Furniture,459
14-02-2023 19:00,1481,1668,East,53,857,115,Furniture,-187
14-02-2023 20:00,3248,1731,East,51,1057,484,Electronics,1517
14-02-2023 21:00,1153,2923,South,76,1850,440,Furniture,-1770
14-02-2023 22:00,4521,665,South,82,1567,992,Furniture,3856
14-02-2023 23:00,2524,2073,North,81,819,868,Electronics,451
15-02-2023 00:00,3120,1116,North,93,1237,897,Groceries,2004
15-02-2023 01:00,3760,2125,South,94,1157,891,Furniture,1635
15-02-2023 02:00,3343,1002,South,95,971,145,Clothing,2341
15-02-2023 03:00,2040,1412,West,86,1792,603,Furniture,628
15-02-2023 04:00,2664,2626,East,76,1024,869,Groceries,38
15-02-2023 05:00,2240,1084,North,77,524,242,Groceries,1156
15-02-2023 06:00,1060,2458,North,52,1139,384,Groceries,-1398
15-02-2023 07:00,1938,895,East,85,1680,454,Groceries,1043
15-02-2023 08:00,2639,2131,East,98,1375,929,Groceries,508
15-02-2023 09:00,3089,2380,North,92,1708,624,Furniture,709
15-02-2023 10:00,1024,901,South,57,673,932,Furniture,123
15-02-2023 11:00,2062,1474,South,93,1917,656,Furniture,588
15-02-2023 12:00,4874,723,East,99,685,146,Furniture,4151
15-02-2023 13:00,1130,1017,North,99,1804,627,Groceries,113
15-02-2023 14:00,4569,735,East,90,1500,993,Groceries,3834
15-02-2023 15:00,2252,615,South,86,1818,206,Clothing,1637
15-02-2023 16:00,1107,725,West,98,1027,102,Furniture,382
15-02-2023 17:00,1171,2777,West,94,1711,715,Groceries,-1606
15-02-2023 18:00,2458,681,South,87,1935,194,Clothing,1777
15-02-2023 19:00,4549,1841,East,71,1471,232,Clothing,2708
15-02-2023 20:00,1101,709,West,63,1183,959,Electronics,392
15-02-2023 21:00,3913,1915,South,64,685,882,Furniture,1998
15-02-2023 22:00,3571,2643,North,95,1074,300,Groceries,928
15-02-2023 23:00,3322,1393,East,53,1824,353,Furniture,1929
16-02-2023 00:00,2636,2381,East,67,808,282,Clothing,255
16-02-2023 01:00,4115,1609,West,50,1712,249,Furniture,2506
16-02-2023 02:00,3864,2962,East,61,1934,648,Electronics,902
16-02-2023 03:00,4004,2526,West,90,1037,589,Electronics,1478
16-02-2023 04:00,2040,893,West,91,1910,604,Groceries,1147
16-02-2023 05:00,1329,1343,South,99,1357,512,Groceries,-14
16-02-2023 06:00,4640,2024,West,66,692,937,Groceries,2616
16-02-2023 07:00,4894,1103,North,68,1686,607,Groceries,3791
16-02-2023 08:00,2520,1081,East,85,552,750,Furniture,1439
16-02-2023 09:00,4886,2542,West,97,974,711,Furniture,2344
16-02-2023 10:00,1011,2439,East,56,673,503,Clothing,-1428
16-02-2023 11:00,2341,632,West,58,1719,335,Clothing,1709
16-02-2023 12:00,4663,2768,South,57,1734,695,Groceries,1895
16-02-2023 13:00,1215,1475,North,74,1199,958,Furniture,-260
16-02-2023 14:00,1338,2313,East,56,889,644,Groceries,-975
16-02-2023 15:00,2799,2043,South,91,1831,732,Clothing,756
16-02-2023 16:00,3708,1857,East,57,956,641,Furniture,1851
16-02-2023 17:00,4152,538,South,73,1854,533,Groceries,3614
16-02-2023 18:00,2750,1816,North,66,1852,645,Electronics,934
16-02-2023 19:00,2508,661,West,61,1552,744,Clothing,1847
16-02-2023 20:00,3421,2409,South,95,621,307,Electronics,1012
16-02-2023 21:00,4023,1627,East,80,1981,239,Electronics,2396
16-02-2023 22:00,1709,2708,East,61,917,687,Furniture,-999
16-02-2023 23:00,2223,2158,South,51,658,686,Electronics,65
17-02-2023 00:00,4608,2463,North,61,1097,919,Electronics,2145
17-02-2023 01:00,3513,1557,North,76,1015,406,Groceries,1956
17-02-2023 02:00,2112,2789,West,95,1525,669,Furniture,-677
17-02-2023 03:00,2291,1466,West,56,1825,197,Groceries,825
17-02-2023 04:00,4726,1389,East,62,1602,224,Groceries,3337
17-02-2023 05:00,4642,2660,East,85,1158,448,Groceries,1982
17-02-2023 06:00,4993,2865,West,50,1177,233,Furniture,2128
17-02-2023 07:00,1488,2570,West,98,814,325,Clothing,-1082
17-02-2023 08:00,4948,2166,West,84,827,811,Furniture,2782
17-02-2023 09:00,2561,1941,South,79,775,648,Groceries,620
17-02-2023 10:00,1046,1567,West,80,1215,749,Clothing,-521
17-02-2023 11:00,4359,627,South,66,951,819,Electronics,3732
17-02-2023 12:00,1777,657,South,57,985,805,Clothing,1120
17-02-2023 13:00,2039,1326,West,52,1630,667,Furniture,713
17-02-2023 14:00,1710,2390,North,59,1066,438,Groceries,-680
17-02-2023 15:00,1400,1011,North,83,745,938,Electronics,389
17-02-2023 16:00,4990,2592,East,71,1434,421,Electronics,2398
17-02-2023 17:00,2817,2766,West,53,1388,912,Groceries,51
17-02-2023 18:00,4028,942,East,81,663,186,Electronics,3086
17-02-2023 19:00,4157,2862,West,78,1026,194,Electronics,1295
17-02-2023 20:00,1249,2724,East,95,500,295,Electronics,-1475
17-02-2023 21:00,1390,2775,South,60,1362,291,Furniture,-1385
17-02-2023 22:00,4853,2226,West,95,636,755,Clothing,2627
17-02-2023 23:00,1334,2506,North,62,650,621,Furniture,-1172
18-02-2023 00:00,1628,2195,West,53,1703,852,Electronics,-567
18-02-2023 01:00,4590,766,East,51,1503,760,Furniture,3824
18-02-2023 02:00,1136,1337,East,83,1541,751,Electronics,-201
18-02-2023 03:00,3930,988,East,92,1748,112,Furniture,2942
18-02-2023 04:00,3735,1201,East,71,1628,353,Clothing,2534
18-02-2023 05:00,4911,1186,East,54,1498,180,Groceries,3725
18-02-2023 06:00,2521,1495,East,58,1197,821,Clothing,1026
18-02-2023 07:00,1826,856,North,69,1588,472,Furniture,970
18-02-2023 08:00,1726,1371,East,70,832,493,Furniture,355
18-02-2023 09:00,2500,2473,North,66,871,989,Clothing,27
18-02-2023 10:00,3641,2751,West,61,1730,831,Furniture,890
18-02-2023 11:00,4294,1051,South,77,1752,517,Groceries,3243
18-02-2023 12:00,1989,2310,North,67,1080,158,Groceries,-321
18-02-2023 13:00,3419,822,West,52,1665,227,Clothing,2597
18-02-2023 14:00,1934,2728,South,54,1185,916,Electronics,-794
18-02-2023 15:00,4042,582,North,63,1208,873,Groceries,3460
18-02-2023 16:00,1401,2850,North,97,1854,879,Furniture,-1449
18-02-2023 17:00,2466,761,West,75,1427,640,Electronics,1705
18-02-2023 18:00,4561,1283,East,68,1239,432,Groceries,3278
18-02-2023 19:00,1614,1723,North,90,770,991,Electronics,-109
18-02-2023 20:00,2296,1413,North,66,1210,381,Furniture,883
18-02-2023 21:00,4597,1443,West,88,824,679,Clothing,3154
18-02-2023 22:00,2182,1818,East,91,1489,306,Clothing,364
18-02-2023 23:00,4223,2035,South,53,1297,371,Furniture,2188
19-02-2023 00:00,4042,1188,East,91,1419,408,Clothing,2854
19-02-2023 01:00,3667,2943,East,84,1046,502,Furniture,724
19-02-2023 02:00,3235,2272,West,73,1592,274,Clothing,963
19-02-2023 03:00,4884,1338,East,90,1407,317,Groceries,3546
19-02-2023 04:00,2121,1377,West,62,711,771,Clothing,744
19-02-2023 05:00,1130,548,South,82,1905,425,Electronics,582
19-02-2023 06:00,3852,792,North,64,1943,855,Clothing,3060
19-02-2023 07:00,2194,2151,North,64,1096,352,Clothing,43
19-02-2023 08:00,3983,1035,West,80,547,553,Clothing,2948
19-02-2023 09:00,4033,810,West,92,730,288,Clothing,3223
19-02-2023 10:00,1182,1036,East,77,1078,872,Groceries,146
19-02-2023 11:00,4030,2426,East,59,1449,542,Furniture,1604
19-02-2023 12:00,1363,733,North,56,1612,997,Groceries,630
19-02-2023 13:00,1038,1732,North,82,1431,229,Groceries,-694
19-02-2023 14:00,4598,2641,North,56,551,584,Electronics,1957
19-02-2023 15:00,4959,2874,West,54,921,102,Furniture,2085
19-02-2023 16:00,3544,2772,South,75,1110,450,Furniture,772
19-02-2023 17:00,4587,1466,South,65,945,654,Electronics,3121
19-02-2023 18:00,2372,1389,West,57,1460,232,Furniture,983
19-02-2023 19:00,4029,2558,East,71,630,789,Clothing,1471
19-02-2023 20:00,1920,534,South,83,1099,593,Furniture,1386
19-02-2023 21:00,4468,946,East,89,873,365,Electronics,3522
19-02-2023 22:00,3769,2263,North,77,1050,123,Electronics,1506
19-02-2023 23:00,4232,2988,North,95,1029,633,Electronics,1244
20-02-2023 00:00,1015,2058,East,85,1628,956,Electronics,-1043
20-02-2023 01:00,1492,1094,North,96,886,102,Groceries,398
20-02-2023 02:00,2449,2525,West,56,835,769,Furniture,-76
20-02-2023 03:00,2131,2776,East,89,1235,979,Groceries,-645
20-02-2023 04:00,3941,843,East,92,1640,526,Electronics,3098
20-02-2023 05:00,4521,1603,East,77,1524,103,Electronics,2918
20-02-2023 06:00,1310,1919,South,51,1395,718,Groceries,-609
20-02-2023 07:00,1738,1813,East,58,1037,907,Clothing,-75
20-02-2023 08:00,4241,1978,East,55,1959,883,Furniture,2263
20-02-2023 09:00,1545,1651,East,50,995,602,Groceries,-106
20-02-2023 10:00,3461,2421,South,52,1535,331,Furniture,1040
20-02-2023 11:00,1250,1882,North,59,1817,972,Electronics,-632
20-02-2023 12:00,1758,2622,South,86,1007,849,Electronics,-864
20-02-2023 13:00,2804,2069,West,93,1180,171,Electronics,735
20-02-2023 14:00,4212,2394,East,72,1064,187,Furniture,1818
20-02-2023 15:00,2297,2743,West,82,1280,627,Furniture,-446
20-02-2023 16:00,4487,2366,South,58,1259,985,Groceries,2121
20-02-2023 17:00,2631,528,North,62,627,702,Electronics,2103
20-02-2023 18:00,4810,1205,North,77,1599,549,Groceries,3605
20-02-2023 19:00,2914,1520,East,56,1792,538,Clothing,1394
20-02-2023 20:00,4110,2563,North,75,645,631,Electronics,1547
20-02-2023 21:00,1813,1946,South,65,1926,534,Electronics,-133
20-02-2023 22:00,1028,2159,South,89,998,823,Clothing,-1131
20-02-2023 23:00,1957,1466,North,75,1465,183,Groceries,491
21-02-2023 00:00,3032,2776,East,88,1059,438,Furniture,256
21-02-2023 01:00,1476,1072,East,81,1722,225,Electronics,404
21-02-2023 02:00,1317,2106,South,85,1423,662,Furniture,-789
21-02-2023 03:00,1244,1114,North,91,902,117,Electronics,130
21-02-2023 04:00,1747,825,South,50,1475,948,Electronics,922
21-02-2023 05:00,1696,858,South,98,1732,964,Furniture,838
21-02-2023 06:00,1271,2310,West,70,841,728,Electronics,-1039
21-02-2023 07:00,4511,2871,South,62,1571,735,Clothing,1640
21-02-2023 08:00,2771,2221,East,75,1040,639,Groceries,550
21-02-2023 09:00,2262,1849,North,94,1699,444,Clothing,413
21-02-2023 10:00,3424,664,North,58,1010,567,Groceries,2760
21-02-2023 11:00,1265,2096,West,86,518,240,Clothing,-831
21-02-2023 12:00,3973,2127,West,72,994,105,Clothing,1846
21-02-2023 13:00,1920,1676,East,50,854,768,Groceries,244
21-02-2023 14:00,4430,1650,West,51,1058,717,Electronics,2780
21-02-2023 15:00,1339,692,South,92,844,730,Furniture,647
21-02-2023 16:00,1388,591,South,77,1583,748,Furniture,797
21-02-2023 17:00,3624,638,East,85,1187,640,Furniture,2986
21-02-2023 18:00,4760,980,North,80,728,777,Electronics,3780
21-02-2023 19:00,3050,2996,East,90,646,164,Clothing,54
21-02-2023 20:00,4500,1856,West,54,1821,155,Clothing,2644
21-02-2023 21:00,2165,839,North,86,1856,897,Clothing,1326
21-02-2023 22:00,1375,1575,North,74,831,981,Electronics,-200
21-02-2023 23:00,4741,1298,North,57,932,195,Groceries,3443
22-02-2023 00:00,3033,974,West,83,898,988,Electronics,2059
22-02-2023 01:00,3371,2948,South,88,1335,314,Furniture,423
22-02-2023 02:00,1145,1962,South,98,1858,842,Clothing,-817
22-02-2023 03:00,2981,1104,West,81,1732,157,Electronics,1877
22-02-2023 04:00,1292,1320,West,60,1934,591,Electronics,-28
22-02-2023 05:00,4736,1097,East,96,1086,504,Electronics,3639
22-02-2023 06:00,1431,2032,East,74,1098,283,Groceries,-601
22-02-2023 07:00,1704,1013,South,52,1794,381,Clothing,691
22-02-2023 08:00,3996,2026,West,94,1703,882,Electronics,1970
22-02-2023 09:00,2998,2377,East,99,1938,820,Electronics,621
22-02-2023 10:00,3632,2199,West,81,1256,262,Furniture,1433
22-02-2023 11:00,1398,1529,West,84,845,188,Clothing,-131
22-02-2023 12:00,3864,999,South,81,1961,882,Electronics,2865
22-02-2023 13:00,4960,2184,South,83,1536,196,Electronics,2776
22-02-2023 14:00,4415,1216,West,86,1927,686,Electronics,3199
22-02-2023 15:00,1963,1641,North,54,1237,187,Electronics,322
22-02-2023 16:00,4211,2008,North,94,879,617,Clothing,2203
22-02-2023 17:00,3234,1165,West,77,920,767,Electronics,2069
22-02-2023 18:00,3041,2708,South,77,1703,162,Groceries,333
22-02-2023 19:00,2828,2817,North,57,1510,640,Electronics,11
22-02-2023 20:00,3108,1579,South,76,1806,915,Groceries,1529
22-02-2023 21:00,1938,727,North,65,917,290,Clothing,1211
22-02-2023 22:00,4451,648,West,67,855,815,Electronics,3803
22-02-2023 23:00,1709,1569,East,74,515,377,Furniture,140
23-02-2023 00:00,1806,1667,East,97,814,638,Groceries,139
23-02-2023 01:00,2463,1131,South,50,1032,184,Groceries,1332
23-02-2023 02:00,4390,1863,South,57,1539,434,Electronics,2527
23-02-2023 03:00,2325,912,North,70,1988,540,Furniture,1413
23-02-2023 04:00,4415,2255,West,83,1986,821,Furniture,2160
23-02-2023 05:00,1010,1019,North,73,1044,749,Electronics,-9
23-02-2023 06:00,2085,1867,West,86,1193,889,Clothing,218
23-02-2023 07:00,2868,2934,West,75,568,271,Clothing,-66
23-02-2023 08:00,3273,2822,South,96,910,951,Electronics,451
23-02-2023 09:00,4224,2900,East,63,1575,438,Clothing,1324
23-02-2023 10:00,4782,1602,East,78,1588,767,Furniture,3180
23-02-2023 11:00,3611,1097,South,79,1311,328,Clothing,2514
23-02-2023 12:00,1771,2159,East,52,1418,917,Clothing,-388
23-02-2023 13:00,2594,2185,South,56,1346,278,Clothing,409
23-02-2023 14:00,2607,2660,North,85,1239,346,Electronics,-53
23-02-2023 15:00,4731,2688,West,60,1990,996,Electronics,2043
23-02-2023 16:00,4932,2424,East,81,1795,773,Groceries,2508
23-02-2023 17:00,4646,1229,East,61,938,774,Clothing,3417
23-02-2023 18:00,2333,1088,North,64,1029,829,Electronics,1245
23-02-2023 19:00,1884,2958,North,87,1229,416,Furniture,-1074
23-02-2023 20:00,4314,876,East,73,772,385,Groceries,3438
23-02-2023 21:00,4564,1907,East,50,958,175,Furniture,2657
23-02-2023 22:00,2389,2369,South,67,1319,551,Clothing,20
23-02-2023 23:00,4401,1250,South,95,1696,303,Furniture,3151
24-02-2023 00:00,4178,1126,East,56,1067,827,Groceries,3052
24-02-2023 01:00,1225,2129,South,91,1360,523,Clothing,-904
24-02-2023 02:00,1824,1494,North,90,996,834,Electronics,330
24-02-2023 03:00,3265,2083,West,51,1294,292,Furniture,1182
24-02-2023 04:00,1936,1202,South,89,1304,392,Furniture,734
24-02-2023 05:00,3800,2559,West,80,1595,803,Groceries,1241
24-02-2023 06:00,3553,1679,South,82,1433,996,Electronics,1874
24-02-2023 07:00,3306,976,East,79,1491,880,Clothing,2330
24-02-2023 08:00,2911,900,South,80,1339,512,Clothing,2011
24-02-2023 09:00,4845,2724,West,83,1695,538,Clothing,2121
24-02-2023 10:00,4588,556,West,56,1134,400,Groceries,4032
24-02-2023 11:00,2796,2375,East,74,1102,359,Furniture,421
24-02-2023 12:00,1053,947,West,65,1235,291,Furniture,106
24-02-2023 13:00,4118,702,East,71,1815,370,Furniture,3416
24-02-2023 14:00,1726,2156,East,85,1775,715,Furniture,-430
24-02-2023 15:00,3736,1237,West,76,1932,531,Groceries,2499
24-02-2023 16:00,2544,701,North,66,1490,815,Groceries,1843
24-02-2023 17:00,4170,1853,West,53,866,795,Electronics,2317
24-02-2023 18:00,2043,2910,West,84,755,316,Groceries,-867
24-02-2023 19:00,2913,1391,South,90,939,190,Furniture,1522
24-02-2023 20:00,2776,2903,West,71,1858,297,Clothing,-127
24-02-2023 21:00,2596,715,South,96,934,498,Electronics,1881
24-02-2023 22:00,2914,522,South,84,1189,138,Clothing,2392
24-02-2023 23:00,4561,2702,West,93,1984,808,Clothing,1859
25-02-2023 00:00,3466,1709,East,64,807,570,Furniture,1757
25-02-2023 01:00,3737,2796,North,89,1618,178,Groceries,941
25-02-2023 02:00,1849,1248,West,93,908,828,Groceries,601
25-02-2023 03:00,3109,1304,West,70,1325,927,Groceries,1805
25-02-2023 04:00,4216,633,East,62,1691,193,Furniture,3583
25-02-2023 05:00,3263,820,South,96,586,783,Furniture,2443
25-02-2023 06:00,1002,2937,East,60,502,142,Clothing,-1935
25-02-2023 07:00,1159,933,East,98,871,231,Electronics,226
25-02-2023 08:00,4810,1545,South,76,1141,176,Groceries,3265
25-02-2023 09:00,1780,1372,West,80,1546,331,Groceries,408
25-02-2023 10:00,4191,2598,East,93,597,138,Electronics,1593
25-02-2023 11:00,1892,2723,East,81,1169,665,Clothing,-831
25-02-2023 12:00,3030,752,West,79,820,250,Clothing,2278
25-02-2023 13:00,4160,1465,West,67,1033,799,Electronics,2695
25-02-2023 14:00,3376,1238,North,65,1319,518,Groceries,2138
25-02-2023 15:00,1579,1629,East,84,866,921,Furniture,-50
25-02-2023 16:00,2933,1839,North,58,1707,285,Furniture,1094
25-02-2023 17:00,2380,801,South,88,916,417,Electronics,1579
25-02-2023 18:00,4681,2477,West,86,1228,563,Groceries,2204
25-02-2023 19:00,2290,2815,West,59,1737,531,Electronics,-525
25-02-2023 20:00,2640,1050,North,61,1347,234,Clothing,1590
25-02-2023 21:00,1951,1978,East,57,1169,602,Clothing,-27
25-02-2023 22:00,4394,1815,South,52,1733,784,Furniture,2579
25-02-2023 23:00,3682,2087,East,68,632,368,Clothing,1595
26-02-2023 00:00,1987,2322,East,60,552,536,Clothing,-335
26-02-2023 01:00,4612,2324,North,57,1240,726,Electronics,2288
26-02-2023 02:00,4720,1664,East,75,1194,597,Electronics,3056
26-02-2023 03:00,2218,813,North,94,522,832,Groceries,1405
26-02-2023 04:00,1920,683,West,72,1629,650,Electronics,1237
26-02-2023 05:00,3785,2187,West,59,959,439,Groceries,1598
26-02-2023 06:00,2355,1212,West,67,1149,341,Furniture,1143
26-02-2023 07:00,1169,2675,South,61,981,320,Electronics,-1506
26-02-2023 08:00,1520,1810,South,88,619,757,Electronics,-290
26-02-2023 09:00,2486,2933,East,75,1172,775,Electronics,-447
26-02-2023 10:00,1039,770,North,60,707,460,Furniture,269
26-02-2023 11:00,2560,2294,East,59,817,979,Electronics,266
26-02-2023 12:00,4332,1310,West,52,837,939,Clothing,3022
26-02-2023 13:00,2418,2962,East,56,654,870,Electronics,-544
26-02-2023 14:00,1954,697,East,53,1367,289,Groceries,1257
26-02-2023 15:00,4297,1579,East,89,1678,512,Clothing,2718
26-02-2023 16:00,1983,1726,West,57,893,428,Electronics,257
26-02-2023 17:00,4195,2144,North,87,1004,875,Electronics,2051
26-02-2023 18:00,1974,1127,East,62,1470,321,Furniture,847
26-02-2023 19:00,1037,1103,West,61,812,943,Groceries,-66
26-02-2023 20:00,3375,1661,South,84,1782,785,Clothing,1714
26-02-2023 21:00,2274,1945,North,87,1680,191,Clothing,329
26-02-2023 22:00,4972,1580,West,92,513,539,Furniture,3392
26-02-2023 23:00,2199,2085,East,85,576,205,Clothing,114
27-02-2023 00:00,2625,2618,West,96,1862,344,Clothing,7
27-02-2023 01:00,1913,1410,North,51,908,404,Groceries,503
27-02-2023 02:00,1453,1093,East,64,893,654,Electronics,360
27-02-2023 03:00,1036,1895,South,98,719,869,Electronics,-859
27-02-2023 04:00,4387,1099,South,83,1243,932,Clothing,3288
27-02-2023 05:00,2711,1013,South,88,932,697,Groceries,1698
27-02-2023 06:00,4020,2395,West,75,1305,196,Furniture,1625
27-02-2023 07:00,1795,2631,North,97,1978,576,Electronics,-836
27-02-2023 08:00,1972,1566,South,54,1663,365,Clothing,406
27-02-2023 09:00,1592,2457,East,97,1487,674,Clothing,-865
27-02-2023 10:00,2137,1309,East,74,1153,202,Groceries,828
27-02-2023 11:00,4111,2680,East,83,1316,353,Groceries,1431
27-02-2023 12:00,2324,1588,West,96,1254,554,Groceries,736
27-02-2023 13:00,3271,789,North,53,1175,928,Clothing,2482
27-02-2023 14:00,1317,2923,North,83,1331,612,Groceries,-1606
27-02-2023 15:00,3396,1268,South,76,1619,765,Clothing,2128
27-02-2023 16:00,3162,970,North,91,527,592,Electronics,2192
27-02-2023 17:00,3745,2696,East,78,1487,360,Clothing,1049
27-02-2023 18:00,2346,587,East,54,1753,134,Clothing,1759
27-02-2023 19:00,2591,2943,West,67,915,480,Electronics,-352
27-02-2023 20:00,4111,1289,East,53,1979,496,Groceries,2822
27-02-2023 21:00,2889,2164,North,50,524,126,Groceries,725
27-02-2023 22:00,3087,1809,East,99,1927,961,Clothing,1278
27-02-2023 23:00,4930,1364,South,69,1172,405,Clothing,3566
28-02-2023 00:00,2996,1793,West,55,1041,835,Electronics,1203
28-02-2023 01:00,2772,523,West,69,664,798,Groceries,2249
28-02-2023 02:00,2312,2386,North,69,707,770,Electronics,-74
28-02-2023 03:00,2285,810,East,95,1448,680,Clothing,1475
28-02-2023 04:00,1215,1984,East,76,1484,264,Clothing,-769
28-02-2023 05:00,4218,1731,North,75,1113,357,Electronics,2487
28-02-2023 06:00,3383,2985,North,81,872,201,Electronics,398
28-02-2023 07:00,4239,1205,South,59,1117,554,Furniture,3034
28-02-2023 08:00,3139,1859,North,67,568,292,Furniture,1280
28-02-2023 09:00,3400,921,East,90,1876,870,Groceries,2479
28-02-2023 10:00,3618,2273,South,61,600,997,Electronics,1345
28-02-2023 11:00,4642,2868,West,59,500,909,Groceries,1774
28-02-2023 12:00,3863,1446,East,73,850,398,Furniture,2417
28-02-2023 13:00,2704,1686,West,73,506,120,Groceries,1018
28-02-2023 14:00,3828,2334,West,87,817,144,Furniture,1494
28-02-2023 15:00,1362,2064,West,95,1122,579,Electronics,-702
28-02-2023 16:00,3604,1348,East,74,1008,595,Electronics,2256
28-02-2023 17:00,4416,2089,West,57,685,887,Groceries,2327
28-02-2023 18:00,2716,1818,East,63,1227,782,Electronics,898
28-02-2023 19:00,2193,2589,West,92,961,789,Groceries,-396
28-02-2023 20:00,1355,2447,North,80,842,322,Groceries,-1092
28-02-2023 21:00,1190,1808,North,73,1134,398,Furniture,-618
28-02-2023 22:00,4738,886,East,65,1212,580,Clothing,3852
28-02-2023 23:00,3469,2535,West,69,1531,123,Groceries,934
01-03-2023 00:00,1699,1661,West,87,1075,437,Furniture,38
01-03-2023 01:00,3054,2525,West,96,635,183,Furniture,529
01-03-2023 02:00,3180,1215,North,64,882,159,Furniture,1965
01-03-2023 03:00,4818,2978,West,63,685,387,Clothing,1840
01-03-2023 04:00,1556,925,West,61,1138,733,Electronics,631
01-03-2023 05:00,1825,1939,East,83,1427,616,Groceries,-114
01-03-2023 06:00,3808,2573,West,57,1895,997,Groceries,1235
01-03-2023 07:00,2054,884,North,68,1463,253,Electronics,1170
01-03-2023 08:00,3582,555,West,95,1060,380,Electronics,3027
01-03-2023 09:00,1425,605,North,54,1689,533,Furniture,820
01-03-2023 10:00,4465,1169,North,76,1397,441,Furniture,3296
01-03-2023 11:00,3719,875,South,90,1138,185,Electronics,2844
01-03-2023 12:00,3410,1242,North,62,820,686,Groceries,2168
01-03-2023 13:00,4508,1466,South,81,1680,878,Electronics,3042
01-03-2023 14:00,4741,807,South,80,1357,290,Electronics,3934
01-03-2023 15:00,2574,2638,West,90,1497,351,Clothing,-64
01-03-2023 16:00,4998,1301,South,95,784,167,Clothing,3697
01-03-2023 17:00,3129,609,East,86,1551,964,Furniture,2520
01-03-2023 18:00,3403,2164,North,51,850,245,Furniture,1239
01-03-2023 19:00,4329,839,East,56,582,975,Groceries,3490
01-03-2023 20:00,4789,2088,South,97,1165,733,Electronics,2701
01-03-2023 21:00,1588,1478,West,60,1893,653,Electronics,110
01-03-2023 22:00,3012,2903,North,60,1040,927,Clothing,109
01-03-2023 23:00,2547,2415,East,72,1918,761,Groceries,132
02-03-2023 00:00,1294,667,West,80,979,673,Electronics,627
02-03-2023 01:00,2985,1056,South,93,712,354,Groceries,1929
02-03-2023 02:00,2247,1404,West,94,1429,230,Clothing,843
02-03-2023 03:00,2548,604,East,57,859,938,Electronics,1944
02-03-2023 04:00,4117,2547,West,81,713,476,Clothing,1570
02-03-2023 05:00,2690,2697,East,97,803,631,Clothing,-7
02-03-2023 06:00,2136,645,West,70,1678,298,Clothing,1491
02-03-2023 07:00,2256,1373,North,80,1903,938,Electronics,883
02-03-2023 08:00,3064,798,West,50,699,320,Groceries,2266
02-03-2023 09:00,1359,2236,North,62,737,509,Electronics,-877
02-03-2023 10:00,4294,1145,East,60,1170,742,Clothing,3149
02-03-2023 11:00,3913,1137,North,78,1690,270,Furniture,2776
02-03-2023 12:00,1699,2786,West,53,1749,244,Groceries,-1087
02-03-2023 13:00,1447,1283,North,85,1378,587,Furniture,164
02-03-2023 14:00,3903,1396,East,64,750,951,Clothing,2507
02-03-2023 15:00,3412,870,West,52,1803,453,Electronics,2542
02-03-2023 16:00,1674,986,North,78,975,280,Groceries,688
02-03-2023 17:00,2007,2537,North,70,997,260,Furniture,-530
02-03-2023 18:00,2349,2712,South,51,1477,563,Electronics,-363
02-03-2023 19:00,3514,1860,North,55,1496,159,Groceries,1654
02-03-2023 20:00,3461,691,South,80,1200,314,Clothing,2770
02-03-2023 21:00,4526,1229,East,73,1934,679,Clothing,3297
02-03-2023 22:00,1585,2761,South,89,1283,972,Clothing,-1176
02-03-2023 23:00,2256,1456,East,66,928,291,Electronics,800
03-03-2023 00:00,2247,880,North,54,1038,587,Electronics,1367
03-03-2023 01:00,1993,1297,North,51,1400,324,Clothing,696
03-03-2023 02:00,4902,738,South,61,1966,491,Clothing,4164
03-03-2023 03:00,2435,1605,East,54,1467,808,Groceries,830
03-03-2023 04:00,1571,1886,North,91,709,260,Furniture,-315
03-03-2023 05:00,3382,2749,South,90,990,860,Groceries,633
03-03-2023 06:00,2245,2027,South,69,970,554,Furniture,218
03-03-2023 07:00,3084,2167,South,57,1067,210,Electronics,917
03-03-2023 08:00,1988,536,North,50,1163,158,Groceries,1452
03-03-2023 09:00,1277,2496,East,55,1986,644,Electronics,-1219
03-03-2023 10:00,2219,1925,North,60,1049,652,Electronics,294
03-03-2023 11:00,3963,1990,West,52,697,772,Furniture,1973
03-03-2023 12:00,2887,1724,West,80,1020,128,Furniture,1163
03-03-2023 13:00,1483,2522,North,77,1848,866,Groceries,-1039
03-03-2023 14:00,2265,2941,East,96,1187,284,Groceries,-676
03-03-2023 15:00,4395,1332,South,92,966,972,Groceries,3063
03-03-2023 16:00,1730,1096,West,54,1095,323,Furniture,634
03-03-2023 17:00,3239,2940,West,75,638,456,Clothing,299
03-03-2023 18:00,2040,1199,North,65,1514,591,Clothing,841
03-03-2023 19:00,3571,2146,West,80,741,832,Furniture,1425
03-03-2023 20:00,1917,2518,West,77,815,931,Groceries,-601
03-03-2023 21:00,3448,940,South,56,1166,697,Clothing,2508
03-03-2023 22:00,4977,2360,South,87,1232,677,Electronics,2617
03-03-2023 23:00,1885,2140,East,58,634,213,Clothing,-255
04-03-2023 00:00,3752,2029,West,88,1711,477,Clothing,1723
04-03-2023 01:00,1021,2867,East,84,1078,876,Furniture,-1846
04-03-2023 02:00,1473,1594,East,92,1592,384,Furniture,-121
04-03-2023 03:00,4191,1067,South,76,938,196,Clothing,3124
04-03-2023 04:00,3257,735,South,61,576,941,Electronics,2522
04-03-2023 05:00,3353,1804,North,74,899,223,Electronics,1549
04-03-2023 06:00,4341,1685,South,92,873,255,Groceries,2656
04-03-2023 07:00,1703,1532,East,78,1535,209,Clothing,171
04-03-2023 08:00,1686,2607,West,80,1257,152,Clothing,-921
04-03-2023 09:00,1284,2340,East,83,1248,273,Electronics,-1056
04-03-2023 10:00,1715,724,East,82,1263,778,Furniture,991
04-03-2023 11:00,4747,2342,East,76,916,687,Clothing,2405
04-03-2023 12:00,1762,1081,South,51,706,413,Electronics,681
04-03-2023 13:00,2250,668,East,63,840,825,Clothing,1582
04-03-2023 14:00,1947,1965,North,62,1220,793,Furniture,-18
04-03-2023 15:00,3428,513,West,73,810,489,Groceries,2915
04-03-2023 16:00,3507,2711,South,54,1831,144,Furniture,796
04-03-2023 17:00,2030,1943,East,83,1816,762,Furniture,87
04-03-2023 18:00,1028,2370,North,72,1124,216,Electronics,-1342
04-03-2023 19:00,1906,2043,West,68,1899,221,Electronics,-137
04-03-2023 20:00,4104,2189,East,79,1863,581,Furniture,1915
04-03-2023 21:00,4717,2071,West,98,582,269,Electronics,2646
04-03-2023 22:00,3926,1551,South,92,1975,777,Furniture,2375
04-03-2023 23:00,3126,2231,South,65,1526,499,Furniture,895
05-03-2023 00:00,4999,945,North,99,1979,941,Clothing,4054
05-03-2023 01:00,3994,1215,South,89,1372,760,Furniture,2779
05-03-2023 02:00,3506,1318,North,83,735,599,Groceries,2188
05-03-2023 03:00,1569,2651,East,98,888,173,Electronics,-1082
05-03-2023 04:00,3006,925,West,60,892,248,Groceries,2081
05-03-2023 05:00,4609,1624,South,63,1246,636,Electronics,2985
05-03-2023 06:00,4553,2064,West,97,529,991,Furniture,2489
05-03-2023 07:00,2453,1349,West,96,1481,160,Groceries,1104
05-03-2023 08:00,1737,2045,East,64,1671,965,Clothing,-308
05-03-2023 09:00,4356,1629,East,84,1104,153,Furniture,2727
05-03-2023 10:00,1515,2202,South,56,782,322,Furniture,-687
05-03-2023 11:00,3000,2501,East,78,737,830,Furniture,499
05-03-2023 12:00,4170,776,West,93,1230,572,Clothing,3394
05-03-2023 13:00,3444,2306,North,71,1842,415,Groceries,1138
05-03-2023 14:00,4560,2735,North,72,1860,269,Furniture,1825
05-03-2023 15:00,1038,2439,North,73,530,800,Groceries,-1401
05-03-2023 16:00,4342,2652,South,84,1477,131,Furniture,1690
05-03-2023 17:00,1886,1045,East,59,1414,152,Furniture,841
05-03-2023 18:00,3844,2927,East,57,706,238,Furniture,917
05-03-2023 19:00,3204,609,East,97,1402,473,Clothing,2595
05-03-2023 20:00,2098,1044,East,97,1752,146,Furniture,1054
05-03-2023 21:00,3931,2901,West,61,1082,189,Groceries,1030
05-03-2023 22:00,2823,1242,North,78,1865,927,Furniture,1581
05-03-2023 23:00,4201,2864,West,78,959,135,Groceries,1337
06-03-2023 00:00,2710,1789,South,72,635,324,Groceries,921
06-03-2023 01:00,1973,2375,North,75,1477,653,Electronics,-402
06-03-2023 02:00,4155,1588,North,86,783,839,Groceries,2567
06-03-2023 03:00,4093,832,West,81,1349,368,Electronics,3261
06-03-2023 04:00,4530,2036,South,87,850,285,Clothing,2494
06-03-2023 05:00,2562,1656,South,55,516,470,Furniture,906
06-03-2023 06:00,4778,1091,North,57,1738,968,Clothing,3687
06-03-2023 07:00,3896,1282,East,66,1918,334,Clothing,2614
06-03-2023 08:00,4453,1039,South,61,1922,221,Groceries,3414
06-03-2023 09:00,3795,2058,West,71,913,523,Furniture,1737
06-03-2023 10:00,4511,2019,South,63,1767,932,Furniture,2492
06-03-2023 11:00,4675,1118,North,83,1618,488,Clothing,3557
06-03-2023 12:00,1988,2333,East,68,505,216,Electronics,-345
06-03-2023 13:00,1020,1491,South,55,1279,565,Electronics,-471
06-03-2023 14:00,3350,2646,North,67,586,528,Groceries,704
06-03-2023 15:00,1868,2864,South,85,688,968,Electronics,-996
06-03-2023 16:00,1083,2670,East,86,919,541,Electronics,-1587
06-03-2023 17:00,4845,2116,West,87,1590,138,Clothing,2729
06-03-2023 18:00,2682,2018,North,64,747,261,Electronics,664
06-03-2023 19:00,2976,1021,North,87,1359,720,Furniture,1955
06-03-2023 20:00,4524,1416,East,89,706,625,Clothing,3108
06-03-2023 21:00,2410,1216,North,58,1728,265,Clothing,1194
06-03-2023 22:00,2530,2862,East,55,1842,973,Electronics,-332
06-03-2023 23:00,4328,2436,North,51,1606,544,Furniture,1892
07-03-2023 00:00,1569,1059,East,65,923,542,Furniture,510
07-03-2023 01:00,4963,1468,South,50,1605,430,Electronics,3495
07-03-2023 02:00,1933,2903,South,79,1048,434,Furniture,-970
07-03-2023 03:00,4598,1577,South,97,986,211,Groceries,3021
07-03-2023 04:00,4233,1389,North,82,632,845,Groceries,2844
07-03-2023 05:00,2980,1292,East,50,614,813,Electronics,1688
07-03-2023 06:00,4234,2812,East,88,876,934,Clothing,1422
07-03-2023 07:00,2855,1481,West,65,1476,238,Clothing,1374
07-03-2023 08:00,4056,1301,South,66,710,878,Furniture,2755
07-03-2023 09:00,1792,542,West,97,631,883,Groceries,1250
07-03-2023 10:00,1791,2109,South,97,1897,265,Clothing,-318
07-03-2023 11:00,4595,2277,West,87,653,513,Furniture,2318
07-03-2023 12:00,2809,849,South,67,1419,268,Groceries,1960
07-03-2023 13:00,2294,2067,East,71,1946,868,Clothing,227
07-03-2023 14:00,3539,1629,South,71,1451,223,Furniture,1910
07-03-2023 15:00,3255,2548,North,84,1305,649,Electronics,707
07-03-2023 16:00,4610,2280,South,80,1889,981,Electronics,2330
07-03-2023 17:00,2607,1083,South,89,646,860,Clothing,1524
07-03-2023 18:00,2083,931,East,76,1650,848,Furniture,1152
07-03-2023 19:00,3477,2432,North,85,1831,197,Groceries,1045
07-03-2023 20:00,1984,2600,East,53,1214,159,Electronics,-616
07-03-2023 21:00,2680,1848,West,98,1641,118,Groceries,832
07-03-2023 22:00,4676,2694,West,54,730,223,Furniture,1982
07-03-2023 23:00,4380,2530,North,74,950,325,Electronics,1850
08-03-2023 00:00,1519,1689,West,80,1668,711,Clothing,-170
08-03-2023 01:00,1590,1662,North,63,1406,423,Electronics,-72
08-03-2023 02:00,2050,798,South,79,1572,116,Clothing,1252
08-03-2023 03:00,2709,2439,West,96,606,859,Groceries,270
08-03-2023 04:00,4633,1288,South,61,592,179,Electronics,3345
08-03-2023 05:00,3035,1349,East,76,1328,696,Furniture,1686
08-03-2023 06:00,3246,2725,West,94,639,959,Groceries,521
08-03-2023 07:00,3434,1877,East,73,1837,555,Groceries,1557
08-03-2023 08:00,1348,1677,East,79,510,640,Clothing,-329
08-03-2023 09:00,1959,2449,North,67,947,745,Furniture,-490
08-03-2023 10:00,2963,1377,East,63,1426,805,Groceries,1586
08-03-2023 11:00,1692,1638,North,68,894,730,Electronics,54
08-03-2023 12:00,2559,2077,North,71,877,477,Clothing,482
08-03-2023 13:00,4899,2992,North,75,860,978,Furniture,1907
08-03-2023 14:00,1377,2146,North,56,1182,290,Clothing,-769
08-03-2023 15:00,3946,2403,North,77,1516,764,Clothing,1543
08-03-2023 16:00,3963,1882,South,87,1141,954,Groceries,2081
08-03-2023 17:00,4629,644,North,54,1072,590,Electronics,3985
08-03-2023 18:00,1526,2822,West,85,1496,504,Electronics,-1296
08-03-2023 19:00,4224,1702,North,67,1422,371,Furniture,2522
08-03-2023 20:00,3781,2361,South,63,895,743,Furniture,1420
08-03-2023 21:00,3253,2354,West,97,685,974,Electronics,899
08-03-2023 22:00,3502,2366,West,72,1744,529,Clothing,1136
08-03-2023 23:00,4344,1598,South,63,1823,619,Clothing,2746
09-03-2023 00:00,4965,1651,West,81,1698,745,Electronics,3314
09-03-2023 01:00,2259,2234,South,54,870,992,Groceries,25
09-03-2023 02:00,2875,1067,East,71,1727,483,Clothing,1808
09-03-2023 03:00,2763,2313,East,77,1107,920,Electronics,450
09-03-2023 04:00,1520,1030,North,92,781,986,Groceries,490
09-03-2023 05:00,2701,2706,North,61,1939,291,Clothing,-5
09-03-2023 06:00,2016,2061,North,67,1556,702,Furniture,-45
09-03-2023 07:00,4003,1180,North,85,581,534,Clothing,2823
09-03-2023 08:00,4902,2570,South,80,647,860,Clothing,2332
09-03-2023 09:00,3773,1570,East,62,1464,863,Electronics,2203
09-03-2023 10:00,2013,1228,South,69,1491,162,Clothing,785
09-03-2023 11:00,3548,2229,West,94,1447,315,Clothing,1319
09-03-2023 12:00,1116,2691,West,85,994,233,Groceries,-1575
09-03-2023 13:00,3433,1167,West,56,1693,718,Electronics,2266
09-03-2023 14:00,2367,2112,West,72,1222,260,Groceries,255
09-03-2023 15:00,1583,1180,West,83,1202,357,Furniture,403
09-03-2023 16:00,1394,1472,East,99,1530,524,Clothing,-78
09-03-2023 17:00,2087,2632,South,81,1903,627,Electronics,-545
09-03-2023 18:00,4788,2963,West,70,1325,457,Furniture,1825
09-03-2023 19:00,3768,1326,North,55,933,474,Electronics,2442
09-03-2023 20:00,1071,796,East,65,1557,670,Clothing,275
09-03-2023 21:00,4860,1753,North,84,1062,108,Electronics,3107
09-03-2023 22:00,1273,2925,East,96,637,296,Electronics,-1652
09-03-2023 23:00,3013,2968,East,69,866,216,Groceries,45
10-03-2023 00:00,2343,2652,North,91,605,109,Electronics,-309
10-03-2023 01:00,1337,2228,North,90,1293,961,Electronics,-891
10-03-2023 02:00,2389,2524,West,60,1555,618,Groceries,-135
10-03-2023 03:00,4566,829,North,81,1135,448,Clothing,3737
10-03-2023 04:00,1606,2986,South,63,1486,805,Furniture,-1380
10-03-2023 05:00,1165,1655,East,73,1457,503,Groceries,-490
10-03-2023 06:00,2567,2390,East,93,1691,734,Clothing,177
10-03-2023 07:00,3058,881,West,88,1354,674,Clothing,2177
10-03-2023 08:00,2324,2685,East,92,577,103,Furniture,-361
10-03-2023 09:00,1728,1342,North,80,708,895,Clothing,386
10-03-2023 10:00,3848,2817,East,66,1934,427,Groceries,1031
10-03-2023 11:00,3043,895,East,74,507,861,Clothing,2148
10-03-2023 12:00,1101,949,North,58,1236,611,Furniture,152
10-03-2023 13:00,4496,1854,North,71,726,229,Furniture,2642
10-03-2023 14:00,2415,2486,East,94,674,686,Groceries,-71
10-03-2023 15:00,1778,1808,South,97,580,583,Groceries,-30
10-03-2023 16:00,1213,1797,North,84,1580,940,Clothing,-584
10-03-2023 17:00,4762,2567,South,86,1658,457,Furniture,2195
10-03-2023 18:00,2111,2786,South,66,737,484,Furniture,-675
10-03-2023 19:00,2576,1793,West,77,1995,353,Clothing,783
10-03-2023 20:00,3448,2965,South,50,1740,934,Furniture,483
10-03-2023 21:00,3635,2349,West,58,1549,266,Groceries,1286
10-03-2023 22:00,3936,685,South,98,686,812,Groceries,3251
10-03-2023 23:00,4117,1733,West,62,1129,779,Clothing,2384
11-03-2023 00:00,2695,1937,North,96,1639,895,Clothing,758
11-03-2023 01:00,4534,752,East,81,1513,568,Clothing,3782
11-03-2023 02:00,1591,518,East,77,1314,959,Groceries,1073
11-03-2023 03:00,2333,1659,West,80,1113,592,Groceries,674
11-03-2023 04:00,2109,722,North,57,1391,437,Furniture,1387
11-03-2023 05:00,3139,502,West,57,1686,150,Groceries,2637
11-03-2023 06:00,4731,1759,West,83,1937,155,Clothing,2972
11-03-2023 07:00,3720,1353,North,72,677,172,Electronics,2367
11-03-2023 08:00,1713,1988,South,59,1484,893,Electronics,-275
11-03-2023 09:00,1935,727,South,86,779,699,Electronics,1208
11-03-2023 10:00,2951,2177,North,97,1297,151,Electronics,774
11-03-2023 11:00,1241,998,West,74,1735,224,Electronics,243
11-03-2023 12:00,3043,2385,East,82,1577,361,Groceries,658
11-03-2023 13:00,4936,2515,West,94,566,984,Clothing,2421
11-03-2023 14:00,1001,1662,South,53,1043,879,Clothing,-661
11-03-2023 15:00,3272,1799,North,56,1019,674,Furniture,1473
11-03-2023 16:00,3848,2838,North,82,998,647,Clothing,1010
11-03-2023 17:00,2768,1576,North,51,1445,620,Furniture,1192
11-03-2023 18:00,2949,1214,South,97,1954,429,Clothing,1735
11-03-2023 19:00,3636,1447,West,95,1226,422,Furniture,2189
11-03-2023 20:00,3163,1369,North,81,1569,340,Furniture,1794
11-03-2023 21:00,4737,1570,East,54,1558,384,Clothing,3167
11-03-2023 22:00,1917,593,North,95,688,938,Electronics,1324
11-03-2023 23:00,4174,1059,West,66,1612,701,Clothing,3115
12-03-2023 00:00,3241,2275,South,61,1858,363,Clothing,966
12-03-2023 01:00,4237,2760,East,61,1446,398,Electronics,1477
12-03-2023 02:00,3918,935,East,84,635,304,Clothing,2983
12-03-2023 03:00,1089,1351,North,70,1045,390,Furniture,-262
12-03-2023 04:00,2709,704,West,70,1292,310,Electronics,2005
12-03-2023 05:00,3169,2928,North,51,1636,465,Electronics,241
12-03-2023 06:00,1142,1599,East,70,1695,889,Groceries,-457
12-03-2023 07:00,4041,576,North,64,1862,563,Furniture,3465
12-03-2023 08:00,1105,1315,West,60,1054,818,Furniture,-210
12-03-2023 09:00,1886,1267,South,59,1393,421,Clothing,619
12-03-2023 10:00,1427,2957,East,67,1445,457,Clothing,-1530
12-03-2023 11:00,2328,605,West,72,1024,193,Furniture,1723
12-03-2023 12:00,2895,2635,North,80,673,810,Furniture,260
12-03-2023 13:00,2994,2246,East,75,1136,962,Furniture,748
12-03-2023 14:00,1316,1965,North,51,1855,268,Clothing,-649
12-03-2023 15:00,2986,744,North,88,706,396,Furniture,2242
12-03-2023 16:00,1634,1905,South,56,1866,838,Furniture,-271
12-03-2023 17:00,2925,1481,North,73,1448,615,Electronics,1444
12-03-2023 18:00,3056,2236,North,88,603,197,Furniture,820
12-03-2023 19:00,3821,641,West,81,1563,804,Groceries,3180
12-03-2023 20:00,4144,1392,North,75,1546,877,Clothing,2752
12-03-2023 21:00,4430,1891,South,72,1775,449,Electronics,2539
12-03-2023 22:00,3270,2899,North,63,789,835,Furniture,371
12-03-2023 23:00,2439,1044,North,78,1725,678,Furniture,1395
13-03-2023 00:00,1552,2699,North,74,1678,749,Electronics,-1147
13-03-2023 01:00,4441,1969,East,80,1066,940,Electronics,2472
13-03-2023 02:00,1715,1262,South,51,1629,500,Electronics,453
13-03-2023 03:00,2287,1123,East,51,1783,850,Groceries,1164
13-03-2023 04:00,4911,1155,South,72,1463,550,Groceries,3756
13-03-2023 05:00,2713,2997,South,96,1723,574,Electronics,-284
13-03-2023 06:00,2883,1747,West,60,1337,920,Furniture,1136
13-03-2023 07:00,4389,542,East,78,1740,518,Clothing,3847
13-03-2023 08:00,2107,2811,South,91,910,103,Groceries,-704
13-03-2023 09:00,2341,1526,South,84,1381,423,Clothing,815
13-03-2023 10:00,1110,2160,West,98,1640,468,Clothing,-1050
13-03-2023 11:00,1250,1791,East,58,1385,963,Groceries,-541
13-03-2023 12:00,3430,1095,North,81,923,713,Clothing,2335
13-03-2023 13:00,3054,1512,West,79,1735,494,Furniture,1542
13-03-2023 14:00,1458,2724,South,64,654,655,Groceries,-1266
13-03-2023 15:00,2107,2610,East,63,1786,218,Groceries,-503
13-03-2023 16:00,1207,1457,South,66,650,799,Clothing,-250
13-03-2023 17:00,1899,1060,West,71,711,842,Clothing,839
13-03-2023 18:00,4461,1830,West,79,1715,289,Electronics,2631
13-03-2023 19:00,4385,1812,East,66,1380,721,Groceries,2573
13-03-2023 20:00,1021,2321,West,65,1254,515,Clothing,-1300
13-03-2023 21:00,1409,2050,West,57,1621,913,Furniture,-641
13-03-2023 22:00,1894,1349,North,88,1040,890,Groceries,545
13-03-2023 23:00,1514,1778,South,80,1200,205,Electronics,-264
14-03-2023 00:00,4198,2033,North,61,671,264,Furniture,2165
14-03-2023 01:00,1808,2314,North,82,870,737,Electronics,-506
14-03-2023 02:00,4771,2241,East,61,1678,445,Electronics,2530
14-03-2023 03:00,1873,1105,West,74,1663,197,Furniture,768
14-03-2023 04:00,1013,1986,South,87,1412,585,Electronics,-973
14-03-2023 05:00,1970,1794,South,97,1301,430,Electronics,176
14-03-2023 06:00,4025,1245,South,67,755,469,Electronics,2780
14-03-2023 07:00,4061,1057,West,68,1489,541,Electronics,3004
14-03-2023 08:00,4083,2611,South,52,1175,219,Electronics,1472
14-03-2023 09:00,3134,1441,South,84,1363,952,Groceries,1693
14-03-2023 10:00,4595,2796,West,54,915,398,Clothing,1799
14-03-2023 11:00,3956,1769,East,84,828,955,Groceries,2187
14-03-2023 12:00,2560,1439,South,76,1901,242,Groceries,1121
14-03-2023 13:00,2324,2110,West,86,1417,806,Clothing,214
14-03-2023 14:00,2266,2704,North,95,1789,741,Clothing,-438
14-03-2023 15:00,3169,2225,West,70,1662,715,Furniture,944
14-03-2023 16:00,4218,1484,North,65,1461,192,Electronics,2734
14-03-2023 17:00,4638,2087,West,77,1323,396,Clothing,2551
14-03-2023 18:00,1749,1836,South,74,748,546,Furniture,-87
14-03-2023 19:00,4427,2374,East,82,1244,579,Furniture,2053
14-03-2023 20:00,1684,1161,East,66,807,833,Groceries,523
14-03-2023 21:00,2927,532,South,92,1072,811,Furniture,2395
14-03-2023 22:00,4804,2316,North,79,1742,899,Electronics,2488
14-03-2023 23:00,4702,2620,West,90,1297,973,Groceries,2082
15-03-2023 00:00,3356,2389,South,53,1500,357,Clothing,967
15-03-2023 01:00,1694,1656,West,51,1260,621,Groceries,38
15-03-2023 02:00,3335,560,South,58,792,782,Groceries,2775
15-03-2023 03:00,1306,2043,South,80,909,474,Electronics,-737
15-03-2023 04:00,4883,771,West,74,697,526,Electronics,4112
15-03-2023 05:00,4665,2793,East,86,579,200,Groceries,1872
15-03-2023 06:00,2989,1699,East,85,1908,721,Clothing,1290
15-03-2023 07:00,3961,2306,North,54,636,858,Electronics,1655
15-03-2023 08:00,4794,1654,West,73,712,934,Groceries,3140
15-03-2023 09:00,1661,1625,North,73,1118,343,Electronics,36
15-03-2023 10:00,1548,809,South,78,1459,122,Electronics,739
15-03-2023 11:00,4423,1815,North,99,1730,453,Furniture,2608
15-03-2023 12:00,1311,2245,South,94,1656,565,Clothing,-934
15-03-2023 13:00,3920,837,West,80,665,324,Groceries,3083
15-03-2023 14:00,2082,509,West,86,929,964,Groceries,1573
15-03-2023 15:00,4714,548,West,68,1703,543,Furniture,4166
15-03-2023 16:00,3971,2010,West,72,620,873,Groceries,1961
15-03-2023 17:00,2737,1844,North,84,1697,368,Groceries,893
15-03-2023 18:00,1754,1230,South,99,830,632,Furniture,524
15-03-2023 19:00,1034,1294,East,55,1591,413,Furniture,-260
15-03-2023 20:00,1444,2148,West,55,1661,219,Groceries,-704
15-03-2023 21:00,3140,632,West,86,1831,580,Furniture,2508
15-03-2023 22:00,2982,2630,South,79,1853,219,Electronics,352
15-03-2023 23:00,2230,2604,East,50,1761,809,Electronics,-374
16-03-2023 00:00,1352,875,West,57,1599,235,Electronics,477
16-03-2023 01:00,1902,2896,East,77,1674,176,Electronics,-994
16-03-2023 02:00,2355,770,West,74,1119,453,Furniture,1585
16-03-2023 03:00,4888,2006,North,82,1839,157,Clothing,2882
16-03-2023 04:00,3909,2658,North,87,536,185,Clothing,1251
16-03-2023 05:00,2748,575,East,63,1463,100,Groceries,2173
16-03-2023 06:00,1158,2456,South,60,1344,176,Clothing,-1298
16-03-2023 07:00,2977,2166,South,51,1649,621,Electronics,811
16-03-2023 08:00,1956,828,North,79,1296,543,Furniture,1128
16-03-2023 09:00,3071,2669,South,79,785,680,Electronics,402
16-03-2023 10:00,1403,540,South,53,1763,247,Electronics,863
16-03-2023 11:00,3852,1690,South,62,1386,673,Furniture,2162
16-03-2023 12:00,1515,2826,East,56,719,624,Electronics,-1311
16-03-2023 13:00,3779,2556,East,87,1530,285,Electronics,1223
16-03-2023 14:00,2387,512,South,52,715,776,Furniture,1875
16-03-2023 15:00,4453,1423,North,58,1180,621,Furniture,3030
16-03-2023 16:00,3579,2342,South,63,792,870,Groceries,1237
16-03-2023 17:00,1955,1732,West,60,542,261,Groceries,223
16-03-2023 18:00,3199,1714,North,86,1830,389,Electronics,1485
16-03-2023 19:00,4633,1152,East,63,1616,520,Groceries,3481
16-03-2023 20:00,2712,2203,West,68,1792,295,Clothing,509
16-03-2023 21:00,3994,1120,South,57,1192,133,Clothing,2874
16-03-2023 22:00,1607,2462,South,56,1738,771,Electronics,-855
16-03-2023 23:00,4688,2145,North,56,1458,696,Groceries,2543
17-03-2023 00:00,3467,2743,North,52,613,669,Electronics,724
17-03-2023 01:00,2273,916,South,52,1708,972,Groceries,1357
17-03-2023 02:00,4188,1163,South,67,1420,507,Furniture,3025
17-03-2023 03:00,3913,2278,North,94,1648,876,Furniture,1635
17-03-2023 04:00,2535,1879,West,82,1628,396,Furniture,656
17-03-2023 05:00,4811,647,East,86,736,636,Furniture,4164
17-03-2023 06:00,3625,2545,North,77,1152,135,Electronics,1080
17-03-2023 07:00,3382,1888,West,85,657,363,Electronics,1494
17-03-2023 08:00,2441,2911,South,65,1997,481,Electronics,-470
17-03-2023 09:00,3979,2225,East,64,1407,213,Clothing,1754
17-03-2023 10:00,2797,901,West,78,1460,716,Furniture,1896
17-03-2023 11:00,1294,2015,East,67,1797,704,Furniture,-721
17-03-2023 12:00,1754,2531,East,98,1352,700,Furniture,-777
17-03-2023 13:00,2394,728,East,95,1640,542,Groceries,1666
17-03-2023 14:00,1185,2098,West,95,1385,262,Groceries,-913
17-03-2023 15:00,2269,767,West,68,559,137,Clothing,1502
17-03-2023 16:00,1636,1928,South,78,900,191,Clothing,-292
17-03-2023 17:00,2291,2316,East,55,1327,730,Groceries,-25
17-03-2023 18:00,4714,1534,North,94,1703,822,Groceries,3180
17-03-2023 19:00,4308,1843,North,99,1755,771,Electronics,2465
17-03-2023 20:00,1529,625,North,96,975,200,Electronics,904
17-03-2023 21:00,4623,2853,West,76,1154,980,Groceries,1770
17-03-2023 22:00,3068,2225,South,56,1344,606,Furniture,843
17-03-2023 23:00,3958,1612,West,76,1423,278,Groceries,2346
18-03-2023 00:00,4808,1875,East,68,1768,383,Electronics,2933
18-03-2023 01:00,3914,1188,North,66,1137,454,Clothing,2726
18-03-2023 02:00,1793,1780,West,90,1148,396,Groceries,13
18-03-2023 03:00,4591,1732,North,60,712,985,Groceries,2859
18-03-2023 04:00,3147,780,West,54,1982,634,Furniture,2367
18-03-2023 05:00,3799,942,North,51,1489,587,Clothing,2857
18-03-2023 06:00,1477,2363,East,96,1303,378,Furniture,-886
18-03-2023 07:00,2622,1336,North,61,627,643,Clothing,1286
18-03-2023 08:00,4369,888,East,91,1451,749,Furniture,3481
18-03-2023 09:00,1939,1116,East,91,716,692,Clothing,823
18-03-2023 10:00,1525,646,West,60,1210,454,Groceries,879
18-03-2023 11:00,3381,1020,West,59,519,418,Groceries,2361
18-03-2023 12:00,1001,1129,West,77,1583,294,Groceries,-128
18-03-2023 13:00,1374,2981,East,56,1174,903,Electronics,-1607
18-03-2023 14:00,3340,2691,South,63,1213,192,Clothing,649
18-03-2023 15:00,3884,788,South,62,1238,532,Clothing,3096
18-03-2023 16:00,4052,1909,East,54,1652,657,Furniture,2143
18-03-2023 17:00,1552,513,East,91,1056,126,Electronics,1039
18-03-2023 18:00,3365,756,West,57,696,514,Furniture,2609
18-03-2023 19:00,2525,2221,West,99,1435,261,Electronics,304
18-03-2023 20:00,2851,1923,West,50,1177,943,Furniture,928
18-03-2023 21:00,1380,1730,South,54,1003,200,Electronics,-350
18-03-2023 22:00,2646,1357,South,60,1770,798,Furniture,1289
18-03-2023 23:00,1013,1695,East,92,1237,572,Furniture,-682
19-03-2023 00:00,1503,963,South,97,1291,805,Electronics,540
19-03-2023 01:00,3278,769,West,59,1783,257,Clothing,2509
19-03-2023 02:00,3008,1744,West,64,1870,591,Furniture,1264
19-03-2023 03:00,4155,1706,West,88,696,108,Electronics,2449
19-03-2023 04:00,1129,571,West,96,1630,311,Electronics,558
19-03-2023 05:00,4814,1806,West,78,1280,538,Clothing,3008
19-03-2023 06:00,1837,2621,North,74,1243,996,Clothing,-784
19-03-2023 07:00,4216,2902,East,97,1683,923,Clothing,1314
19-03-2023 08:00,3938,2250,East,55,921,778,Clothing,1688
19-03-2023 09:00,4928,996,South,60,1730,954,Furniture,3932
19-03-2023 10:00,3040,1487,West,66,1836,885,Furniture,1553
19-03-2023 11:00,1027,1409,North,64,931,909,Groceries,-382
19-03-2023 12:00,3113,872,West,65,1425,210,Furniture,2241
19-03-2023 13:00,4234,861,West,51,734,940,Groceries,3373
19-03-2023 14:00,2252,2640,South,85,826,302,Groceries,-388
19-03-2023 15:00,1260,1844,North,68,1433,859,Furniture,-584
19-03-2023 16:00,3046,823,North,87,978,164,Groceries,2223
19-03-2023 17:00,2472,2931,East,99,927,814,Clothing,-459
19-03-2023 18:00,2447,1074,West,70,1165,260,Groceries,1373
19-03-2023 19:00,1459,1235,North,60,1623,513,Furniture,224
19-03-2023 20:00,4747,2893,East,90,1761,744,Electronics,1854
19-03-2023 21:00,1300,1715,North,52,1630,789,Furniture,-415
19-03-2023 22:00,3966,2195,West,83,1357,804,Electronics,1771
19-03-2023 23:00,4374,2407,East,67,1887,365,Electronics,1967
20-03-2023 00:00,3334,1218,North,64,1141,671,Groceries,2116
20-03-2023 01:00,4466,1280,South,74,1310,304,Groceries,3186
20-03-2023 02:00,4081,1519,North,99,1566,766,Electronics,2562
20-03-2023 03:00,4778,1903,West,64,1074,683,Groceries,2875
20-03-2023 04:00,1629,1926,South,79,1596,255,Clothing,-297
20-03-2023 05:00,1269,1163,North,66,1518,272,Furniture,106
20-03-2023 06:00,3639,2272,North,67,1827,407,Groceries,1367
20-03-2023 07:00,2993,510,East,80,1528,549,Electronics,2483
20-03-2023 08:00,2628,2734,West,99,1302,161,Electronics,-106
20-03-2023 09:00,2801,1538,North,92,1872,472,Furniture,1263
20-03-2023 10:00,3891,2958,North,67,899,559,Groceries,933
20-03-2023 11:00,1861,1084,North,84,1094,574,Groceries,777
20-03-2023 12:00,4432,1575,West,62,1956,480,Electronics,2857
20-03-2023 13:00,2280,1874,South,63,1630,816,Furniture,406
20-03-2023 14:00,3180,1951,West,85,616,671,Electronics,1229
20-03-2023 15:00,4347,2354,East,67,882,185,Furniture,1993
20-03-2023 16:00,2799,2289,East,54,1358,242,Groceries,510
20-03-2023 17:00,2706,1242,West,63,581,962,Groceries,1464
20-03-2023 18:00,4019,2276,North,74,1331,106,Furniture,1743
20-03-2023 19:00,3560,703,North,93,1372,394,Electronics,2857
20-03-2023 20:00,3360,1576,South,88,1152,790,Electronics,1784
20-03-2023 21:00,1575,1473,West,61,1233,838,Electronics,102
20-03-2023 22:00,3933,1898,West,89,1933,618,Furniture,2035
20-03-2023 23:00,3003,2365,North,77,569,751,Furniture,638
21-03-2023 00:00,2307,1799,East,84,886,625,Electronics,508
21-03-2023 01:00,4192,1554,East,50,1023,133,Electronics,2638
21-03-2023 02:00,4178,1658,South,52,796,989,Furniture,2520
21-03-2023 03:00,2956,604,South,92,1116,851,Furniture,2352
21-03-2023 04:00,3734,752,East,99,1218,428,Electronics,2982
21-03-2023 05:00,3020,794,West,56,1588,931,Electronics,2226
21-03-2023 06:00,4275,1681,South,58,677,708,Groceries,2594
21-03-2023 07:00,3212,1048,North,85,1531,879,Clothing,2164
21-03-2023 08:00,3352,2277,West,72,1682,737,Furniture,1075
21-03-2023 09:00,4568,798,North,73,510,133,Clothing,3770
21-03-2023 10:00,2655,2248,South,59,1284,894,Furniture,407
21-03-2023 11:00,2579,2343,East,99,910,505,Groceries,236
21-03-2023 12:00,2847,600,South,97,1391,117,Furniture,2247
21-03-2023 13:00,3203,2879,East,61,1106,529,Furniture,324
21-03-2023 14:00,2390,2274,West,68,654,527,Clothing,116
21-03-2023 15:00,2742,2940,South,81,1729,392,Groceries,-198
21-03-2023 16:00,2925,1373,South,73,1638,679,Groceries,1552
21-03-2023 17:00,1619,2928,South,71,1902,848,Groceries,-1309
21-03-2023 18:00,2274,591,West,52,1098,179,Groceries,1683
21-03-2023 19:00,1956,946,North,89,1323,185,Furniture,1010
21-03-2023 20:00,2939,608,North,76,849,671,Clothing,2331
21-03-2023 21:00,4953,816,East,68,1621,147,Groceries,4137
21-03-2023 22:00,3381,2335,South,58,1442,790,Electronics,1046
21-03-2023 23:00,4713,2443,North,98,518,967,Groceries,2270
22-03-2023 00:00,1968,1958,West,62,812,183,Clothing,10
22-03-2023 01:00,3558,941,South,51,1426,706,Clothing,2617
22-03-2023 02:00,2316,2765,East,85,1027,407,Clothing,-449
22-03-2023 03:00,2043,1745,North,78,1056,351,Clothing,298
22-03-2023 04:00,1281,2051,West,60,944,580,Electronics,-770
22-03-2023 05:00,3844,777,West,83,730,944,Groceries,3067
22-03-2023 06:00,4072,1068,East,53,1124,279,Furniture,3004
22-03-2023 07:00,3166,1509,North,53,1510,695,Furniture,1657
22-03-2023 08:00,2058,1338,South,50,1388,409,Electronics,720
22-03-2023 09:00,1197,2107,West,74,858,525,Groceries,-910
22-03-2023 10:00,3532,529,East,75,1906,585,Groceries,3003
22-03-2023 11:00,4828,2906,West,60,543,761,Furniture,1922
22-03-2023 12:00,2082,2442,West,72,1888,138,Electronics,-360
22-03-2023 13:00,3884,2633,North,51,1376,378,Furniture,1251
22-03-2023 14:00,2184,1757,North,68,1634,915,Electronics,427
22-03-2023 15:00,2008,2860,South,78,722,724,Clothing,-852
22-03-2023 16:00,3738,864,West,89,1909,475,Groceries,2874
22-03-2023 17:00,2229,2300,East,53,1401,738,Groceries,-71
22-03-2023 18:00,2035,2322,West,65,1788,140,Groceries,-287
22-03-2023 19:00,1489,2362,East,96,770,769,Groceries,-873
22-03-2023 20:00,1275,1404,West,86,711,817,Groceries,-129
22-03-2023 21:00,3740,1197,East,76,1837,146,Groceries,2543
22-03-2023 22:00,3289,2678,West,54,1910,583,Clothing,611
22-03-2023 23:00,2239,2355,West,64,746,284,Groceries,-116
23-03-2023 00:00,2274,850,South,72,1447,171,Clothing,1424
23-03-2023 01:00,4882,679,North,98,1320,668,Groceries,4203
23-03-2023 02:00,1125,2003,North,52,1873,850,Groceries,-878
23-03-2023 03:00,1216,1686,East,67,571,673,Electronics,-470
23-03-2023 04:00,4377,2306,West,92,1819,441,Groceries,2071
23-03-2023 05:00,4868,1273,West,75,1736,668,Furniture,3595
23-03-2023 06:00,2208,1009,North,55,794,342,Electronics,1199
23-03-2023 07:00,4110,864,East,93,670,427,Electronics,3246
23-03-2023 08:00,2246,852,South,66,745,735,Electronics,1394
23-03-2023 09:00,4255,1606,South,95,1664,252,Furniture,2649
23-03-2023 10:00,3542,1748,South,87,1116,354,Clothing,1794
23-03-2023 11:00,3474,911,West,91,739,828,Electronics,2563
23-03-2023 12:00,4249,1234,East,97,810,523,Electronics,3015
23-03-2023 13:00,1918,617,North,99,1939,331,Electronics,1301
23-03-2023 14:00,4499,981,West,76,897,628,Groceries,3518
23-03-2023 15:00,2317,691,West,69,1422,691,Clothing,1626
23-03-2023 16:00,4923,606,South,55,1291,595,Furniture,4317
23-03-2023 17:00,3198,881,East,84,521,275,Furniture,2317
23-03-2023 18:00,3431,1282,East,61,1601,650,Clothing,2149
23-03-2023 19:00,2661,2937,South,97,1312,242,Clothing,-276
23-03-2023 20:00,4884,743,South,52,1403,116,Clothing,4141
23-03-2023 21:00,1307,967,South,97,1998,348,Groceries,340
23-03-2023 22:00,2359,1365,West,53,1331,134,Electronics,994
23-03-2023 23:00,2969,2061,West,94,1876,900,Groceries,908
24-03-2023 00:00,3793,1733,West,53,1894,245,Clothing,2060
24-03-2023 01:00,1891,1103,North,53,1544,826,Groceries,788
24-03-2023 02:00,1374,2160,North,88,1006,264,Furniture,-786
24-03-2023 03:00,4079,1596,East,70,659,210,Groceries,2483
24-03-2023 04:00,3033,2515,South,93,1243,746,Clothing,518
24-03-2023 05:00,2364,2158,South,51,1884,173,Electronics,206
24-03-2023 06:00,1128,2233,West,65,1312,767,Groceries,-1105
24-03-2023 07:00,2014,2113,North,56,1820,826,Clothing,-99
24-03-2023 08:00,2799,1359,South,68,1875,453,Groceries,1440
24-03-2023 09:00,3716,2379,East,92,679,373,Furniture,1337
24-03-2023 10:00,4423,1776,South,82,1995,378,Groceries,2647
24-03-2023 11:00,2381,512,West,58,1918,759,Groceries,1869
24-03-2023 12:00,1516,2846,West,86,712,130,Electronics,-1330
24-03-2023 13:00,2518,1599,North,66,1029,625,Groceries,919
24-03-2023 14:00,1085,1574,East,76,1918,634,Groceries,-489
24-03-2023 15:00,2198,1286,East,82,526,609,Furniture,912
24-03-2023 16:00,4873,648,South,98,1438,613,Furniture,4225
24-03-2023 17:00,4264,2254,East,61,1369,277,Furniture,2010
24-03-2023 18:00,3358,2669,South,94,1972,428,Electronics,689
24-03-2023 19:00,2142,1803,South,60,937,670,Furniture,339
24-03-2023 20:00,4289,1679,North,62,784,900,Furniture,2610
24-03-2023 21:00,3474,2923,East,80,1160,787,Groceries,551
24-03-2023 22:00,2993,581,West,62,1148,271,Groceries,2412
24-03-2023 23:00,4485,991,South,87,688,495,Electronics,3494
25-03-2023 00:00,3161,2903,South,75,1722,694,Furniture,258
25-03-2023 01:00,4216,2525,South,80,1625,834,Clothing,1691
25-03-2023 02:00,4609,1424,East,71,978,134,Groceries,3185
25-03-2023 03:00,4719,1796,East,55,1102,396,Clothing,2923
25-03-2023 04:00,1302,2103,East,69,1514,568,Clothing,-801
25-03-2023 05:00,3791,2096,South,70,1747,594,Furniture,1695
25-03-2023 06:00,4952,622,West,59,1016,721,Clothing,4330
25-03-2023 07:00,1587,1207,West,68,1964,334,Electronics,380
25-03-2023 08:00,1986,2877,East,84,1415,138,Electronics,-891
25-03-2023 09:00,2863,1490,West,75,729,318,Groceries,1373
25-03-2023 10:00,1344,2870,South,56,1368,316,Clothing,-1526
25-03-2023 11:00,1813,2540,East,86,1637,805,Electronics,-727
25-03-2023 12:00,2987,2980,East,57,1707,774,Electronics,7
25-03-2023 13:00,3848,1209,South,54,1258,727,Clothing,2639
25-03-2023 14:00,4072,1293,East,93,533,939,Electronics,2779
25-03-2023 15:00,4218,1211,South,85,795,772,Clothing,3007
25-03-2023 16:00,2310,2217,East,77,952,700,Electronics,93
25-03-2023 17:00,2999,756,West,99,1929,519,Clothing,2243
25-03-2023 18:00,2677,1712,East,52,1650,752,Electronics,965
25-03-2023 19:00,4124,1370,East,88,641,923,Electronics,2754
25-03-2023 20:00,2327,2231,East,57,1147,273,Electronics,96
25-03-2023 21:00,2092,1308,North,64,627,812,Furniture,784
25-03-2023 22:00,3408,770,West,76,1334,966,Furniture,2638
25-03-2023 23:00,4673,2043,South,98,1424,913,Electronics,2630
26-03-2023 00:00,4291,1049,North,85,1229,967,Furniture,3242
26-03-2023 01:00,2009,1637,West,65,1873,212,Clothing,372
26-03-2023 02:00,1703,1067,East,75,962,978,Furniture,636
26-03-2023 03:00,1574,858,East,94,1767,273,Groceries,716
26-03-2023 04:00,2608,2173,South,93,1063,173,Groceries,435
26-03-2023 05:00,4232,2137,South,53,1709,936,Electronics,2095
26-03-2023 06:00,4752,1857,West,61,1756,898,Furniture,2895
26-03-2023 07:00,2112,2212,West,66,1013,736,Groceries,-100
26-03-2023 08:00,1687,1862,South,90,500,635,Electronics,-175
26-03-2023 09:00,3828,1297,West,93,1762,131,Groceries,2531
26-03-2023 10:00,3632,1784,South,75,1578,353,Electronics,1848
26-03-2023 11:00,4828,1386,East,80,1941,596,Groceries,3442
26-03-2023 12:00,3636,2258,South,64,1971,212,Groceries,1378
26-03-2023 13:00,4230,1722,North,83,837,294,Furniture,2508
26-03-2023 14:00,1488,2758,South,78,1407,627,Electronics,-1270
26-03-2023 15:00,4018,786,South,58,1317,540,Groceries,3232
26-03-2023 16:00,2347,2215,North,63,1800,588,Electronics,132
26-03-2023 17:00,4681,2285,North,85,1533,596,Furniture,2396
26-03-2023 18:00,4452,1242,North,53,1864,823,Groceries,3210
26-03-2023 19:00,4173,2005,North,87,1627,719,Clothing,2168
26-03-2023 20:00,1493,2540,South,86,844,123,Clothing,-1047
26-03-2023 21:00,2667,1546,West,73,1893,389,Clothing,1121
26-03-2023 22:00,2637,795,North,66,1476,995,Electronics,1842
26-03-2023 23:00,1018,2553,East,62,1382,407,Furniture,-1535
27-03-2023 00:00,4525,1180,South,69,697,403,Electronics,3345
27-03-2023 01:00,4553,2391,West,66,1537,954,Electronics,2162
27-03-2023 02:00,4665,1294,East,76,1371,730,Clothing,3371
27-03-2023 03:00,3444,702,South,82,1861,792,Furniture,2742
27-03-2023 04:00,2000,824,South,70,1041,137,Groceries,1176
27-03-2023 05:00,4350,2791,East,66,956,485,Electronics,1559
27-03-2023 06:00,1850,826,North,71,1249,844,Clothing,1024
27-03-2023 07:00,2388,1486,North,74,1959,680,Electronics,902
27-03-2023 08:00,2354,1260,East,52,865,181,Electronics,1094
27-03-2023 09:00,4712,1536,West,76,900,217,Furniture,3176
27-03-2023 10:00,2367,1406,North,76,1073,920,Groceries,961
27-03-2023 11:00,1821,1903,South,95,981,149,Electronics,-82
27-03-2023 12:00,1454,864,South,61,609,768,Electronics,590
27-03-2023 13:00,2624,1744,West,64,1518,173,Groceries,880
27-03-2023 14:00,3772,2620,South,87,905,794,Furniture,1152
27-03-2023 15:00,4726,2148,North,69,808,205,Electronics,2578
27-03-2023 16:00,4136,1569,West,71,659,800,Furniture,2567
27-03-2023 17:00,4147,773,North,51,1343,917,Furniture,3374
27-03-2023 18:00,1710,2755,West,53,554,883,Electronics,-1045
27-03-2023 19:00,3190,2452,East,94,1260,698,Groceries,738
27-03-2023 20:00,1916,2384,South,62,755,961,Electronics,-468
27-03-2023 21:00,4986,623,West,81,1033,425,Electronics,4363
27-03-2023 22:00,3875,1852,East,71,921,783,Clothing,2023
27-03-2023 23:00,3652,2191,North,74,1445,863,Groceries,1461
28-03-2023 00:00,2496,2607,East,76,1461,455,Clothing,-111
28-03-2023 01:00,2440,941,North,66,1312,567,Groceries,1499
28-03-2023 02:00,1304,1740,West,55,1386,755,Electronics,-436
28-03-2023 03:00,1735,1410,West,92,763,383,Furniture,325
28-03-2023 04:00,4568,1525,South,65,1247,284,Clothing,3043
28-03-2023 05:00,3338,2059,South,57,1332,253,Clothing,1279
28-03-2023 06:00,2963,2241,West,82,732,953,Clothing,722
28-03-2023 07:00,3149,2234,North,59,1179,217,Clothing,915
28-03-2023 08:00,3009,1125,North,83,732,366,Groceries,1884
28-03-2023 09:00,4338,2190,West,68,1568,484,Furniture,2148
28-03-2023 10:00,3914,1497,North,63,1057,936,Furniture,2417
28-03-2023 11:00,4015,590,West,52,1412,354,Electronics,3425
28-03-2023 12:00,4693,2714,South,90,1180,340,Electronics,1979
28-03-2023 13:00,4021,706,North,72,1959,270,Clothing,3315
28-03-2023 14:00,3889,1588,South,89,834,716,Electronics,2301
28-03-2023 15:00,1961,2411,East,60,903,647,Electronics,-450
28-03-2023 16:00,3989,1015,South,96,1687,677,Groceries,2974
28-03-2023 17:00,4848,1680,East,55,755,284,Electronics,3168
28-03-2023 18:00,2026,2292,South,83,1589,801,Electronics,-266
28-03-2023 19:00,3132,2853,South,50,1519,766,Electronics,279
28-03-2023 20:00,4865,2401,North,84,1440,992,Furniture,2464
28-03-2023 21:00,3375,2505,South,74,1271,509,Furniture,870
28-03-2023 22:00,3863,894,West,78,1445,838,Electronics,2969
28-03-2023 23:00,2473,1597,North,72,1611,752,Clothing,876
29-03-2023 00:00,3501,686,North,67,1763,687,Furniture,2815
29-03-2023 01:00,2947,2097,North,63,810,245,Groceries,850
29-03-2023 02:00,3676,2091,South,66,1181,137,Groceries,1585
29-03-2023 03:00,4292,1229,North,51,1781,589,Groceries,3063
29-03-2023 04:00,2177,739,East,80,1957,361,Electronics,1438
29-03-2023 05:00,1664,640,East,68,628,225,Clothing,1024
29-03-2023 06:00,1011,638,South,81,1280,703,Groceries,373
29-03-2023 07:00,2156,569,North,77,825,895,Clothing,1587
29-03-2023 08:00,1303,884,West,90,1289,444,Groceries,419
29-03-2023 09:00,4364,1129,West,57,516,360,Clothing,3235
29-03-2023 10:00,4022,2745,East,91,1198,542,Electronics,1277
29-03-2023 11:00,4371,704,South,90,1508,978,Electronics,3667
29-03-2023 12:00,2763,2249,South,89,841,207,Groceries,514
29-03-2023 13:00,3830,1067,South,88,1502,656,Groceries,2763
29-03-2023 14:00,1042,1481,South,71,1337,979,Furniture,-439
29-03-2023 15:00,1943,1304,South,73,1127,536,Groceries,639
29-03-2023 16:00,3390,2210,North,87,1270,613,Furniture,1180
29-03-2023 17:00,2349,1381,North,51,1377,812,Furniture,968
29-03-2023 18:00,4885,2535,North,90,1772,189,Electronics,2350
29-03-2023 19:00,3545,1473,West,90,1209,314,Electronics,2072
29-03-2023 20:00,3411,1139,North,68,1348,726,Furniture,2272
29-03-2023 21:00,1890,1954,South,90,1238,418,Groceries,-64
29-03-2023 22:00,3474,824,South,51,676,703,Furniture,2650
29-03-2023 23:00,2004,941,West,77,1445,937,Groceries,1063
30-03-2023 00:00,1020,1303,West,81,856,797,Electronics,-283
30-03-2023 01:00,1406,2835,East,68,994,871,Groceries,-1429
30-03-2023 02:00,3666,725,West,65,534,769,Furniture,2941
30-03-2023 03:00,2014,1587,East,79,1930,156,Groceries,427
30-03-2023 04:00,1335,1466,North,71,1317,658,Furniture,-131
30-03-2023 05:00,2838,1059,South,63,509,501,Groceries,1779
30-03-2023 06:00,4188,1213,East,50,1485,321,Furniture,2975
30-03-2023 07:00,2147,997,East,94,1030,574,Electronics,1150
30-03-2023 08:00,3446,2607,East,51,594,207,Furniture,839
30-03-2023 09:00,3840,756,West,71,1075,962,Electronics,3084
30-03-2023 10:00,2827,1076,West,95,949,911,Furniture,1751
30-03-2023 11:00,1714,2786,West,82,1743,279,Furniture,-1072
30-03-2023 12:00,1050,537,East,64,1517,276,Clothing,513
30-03-2023 13:00,4854,2572,North,99,595,586,Clothing,2282
30-03-2023 14:00,1323,909,South,90,1364,513,Clothing,414
30-03-2023 15:00,1788,960,West,71,1904,791,Clothing,828
30-03-2023 16:00,1140,1940,North,89,1168,136,Groceries,-800
30-03-2023 17:00,1469,2904,West,88,706,674,Electronics,-1435
30-03-2023 18:00,1786,882,West,90,1349,367,Electronics,904
30-03-2023 19:00,2825,2332,East,90,745,884,Clothing,493
30-03-2023 20:00,2357,1068,East,60,1383,901,Groceries,1289
30-03-2023 21:00,2916,1571,West,53,582,487,Furniture,1345
30-03-2023 22:00,1963,932,South,56,816,453,Furniture,1031
30-03-2023 23:00,4055,555,West,70,1144,913,Electronics,3500
31-03-2023 00:00,1372,2815,South,56,1628,369,Electronics,-1443
31-03-2023 01:00,4635,2616,North,53,869,368,Groceries,2019
31-03-2023 02:00,3541,2251,West,61,1248,541,Furniture,1290
31-03-2023 03:00,4610,2547,South,76,1129,404,Groceries,2063
31-03-2023 04:00,2692,1401,North,66,679,345,Furniture,1291
31-03-2023 05:00,3798,2124,North,69,1101,277,Clothing,1674
31-03-2023 06:00,2179,756,East,80,1099,166,Clothing,1423
31-03-2023 07:00,3338,1171,North,75,1606,376,Groceries,2167
31-03-2023 08:00,2671,989,East,80,1340,307,Electronics,1682
31-03-2023 09:00,4215,2596,North,84,847,406,Groceries,1619
31-03-2023 10:00,1105,2182,North,58,1795,649,Groceries,-1077
31-03-2023 11:00,2443,815,South,54,830,730,Furniture,1628
31-03-2023 12:00,3717,2960,South,97,1109,637,Furniture,757
31-03-2023 13:00,2681,933,East,57,1243,617,Furniture,1748
31-03-2023 14:00,1001,1525,West,70,1068,373,Furniture,-524
31-03-2023 15:00,3636,2475,South,65,888,332,Electronics,1161
31-03-2023 16:00,3691,2479,North,65,1470,213,Electronics,1212
31-03-2023 17:00,3137,1889,East,67,1246,233,Clothing,1248
31-03-2023 18:00,4416,919,East,96,636,524,Groceries,3497
31-03-2023 19:00,1349,2096,East,77,1884,924,Clothing,-747
31-03-2023 20:00,4530,2084,North,67,781,789,Furniture,2446
31-03-2023 21:00,2286,1343,South,63,1725,124,Groceries,943
31-03-2023 22:00,4422,1967,West,97,1518,659,Furniture,2455
31-03-2023 23:00,4179,933,East,86,1243,379,Groceries,3246
01-04-2023 00:00,4657,2078,North,89,1030,442,Electronics,2579
01-04-2023 01:00,2062,2604,South,65,515,912,Furniture,-542
01-04-2023 02:00,3956,1463,South,70,1504,910,Groceries,2493
01-04-2023 03:00,3206,1476,West,50,1067,171,Groceries,1730
01-04-2023 04:00,4654,545,East,60,1637,300,Furniture,4109
01-04-2023 05:00,4006,1693,North,60,1591,425,Electronics,2313
01-04-2023 06:00,3359,916,South,51,529,132,Electronics,2443
01-04-2023 07:00,4312,1347,North,81,1163,196,Electronics,2965
01-04-2023 08:00,1444,2686,South,68,1498,656,Groceries,-1242
01-04-2023 09:00,3345,746,East,54,1374,362,Electronics,2599
01-04-2023 10:00,1951,729,East,52,521,973,Groceries,1222
01-04-2023 11:00,1035,1291,West,77,1954,169,Clothing,-256
01-04-2023 12:00,2107,1136,South,75,1553,912,Electronics,971
01-04-2023 13:00,2475,2921,North,72,1455,392,Furniture,-446
01-04-2023 14:00,4957,1237,South,79,1159,829,Furniture,3720
01-04-2023 15:00,2798,1588,North,57,1933,306,Furniture,1210
01-04-2023 16:00,2845,587,West,85,1572,271,Furniture,2258
01-04-2023 17:00,2408,1212,South,78,824,857,Clothing,1196
01-04-2023 18:00,2195,2249,East,62,1821,494,Clothing,-54
01-04-2023 19:00,2399,1727,North,74,680,355,Electronics,672
01-04-2023 20:00,2708,2436,East,71,621,363,Electronics,272
01-04-2023 21:00,2385,1905,West,95,623,363,Furniture,480
01-04-2023 22:00,3606,1100,West,82,1976,616,Furniture,2506
01-04-2023 23:00,3938,1999,North,86,765,109,Furniture,1939
02-04-2023 00:00,3188,713,South,56,527,370,Groceries,2475
02-04-2023 01:00,3934,2621,East,72,1782,841,Electronics,1313
02-04-2023 02:00,4989,2608,East,55,576,411,Furniture,2381
02-04-2023 03:00,4189,1197,North,64,931,469,Furniture,2992
02-04-2023 04:00,2300,1742,North,64,1378,666,Furniture,558
02-04-2023 05:00,3773,2559,North,89,1393,998,Clothing,1214
02-04-2023 06:00,2243,2579,West,83,1558,652,Clothing,-336
02-04-2023 07:00,4976,1683,West,63,935,749,Clothing,3293
02-04-2023 08:00,4097,1500,East,78,1637,490,Groceries,2597
02-04-2023 09:00,1520,736,South,65,1585,214,Groceries,784
02-04-2023 10:00,2806,1704,North,78,551,674,Electronics,1102
02-04-2023 11:00,1009,1981,West,72,615,443,Furniture,-972
02-04-2023 12:00,1983,1603,South,59,546,509,Electronics,380
02-04-2023 13:00,3425,1146,North,96,937,645,Electronics,2279
02-04-2023 14:00,2656,972,South,53,1935,477,Clothing,1684
02-04-2023 15:00,2660,611,North,61,600,863,Furniture,2049
02-04-2023 16:00,3729,2345,South,91,1802,555,Clothing,1384
02-04-2023 17:00,3631,2154,East,83,606,522,Clothing,1477
02-04-2023 18:00,3199,882,North,53,1482,543,Furniture,2317
02-04-2023 19:00,1719,516,North,69,1558,296,Electronics,1203
02-04-2023 20:00,2072,992,East,77,1500,967,Electronics,1080
02-04-2023 21:00,4225,2396,North,77,858,462,Clothing,1829
02-04-2023 22:00,1858,2009,North,55,1386,509,Furniture,-151
02-04-2023 23:00,2316,616,West,63,1299,863,Electronics,1700
03-04-2023 00:00,2603,2078,East,84,1525,673,Groceries,525
03-04-2023 01:00,1049,1379,West,96,1795,493,Electronics,-330
03-04-2023 02:00,3711,2662,East,50,1667,836,Furniture,1049
03-04-2023 03:00,3578,2318,South,68,934,608,Furniture,1260
03-04-2023 04:00,4683,2072,East,50,1974,967,Furniture,2611
03-04-2023 05:00,4131,2148,East,62,1103,665,Clothing,1983
03-04-2023 06:00,4238,1143,West,57,1065,770,Electronics,3095
03-04-2023 07:00,4273,1859,North,67,1415,393,Groceries,2414
03-04-2023 08:00,3904,835,East,84,727,981,Clothing,3069
03-04-2023 09:00,1145,646,North,72,1044,124,Electronics,499
03-04-2023 10:00,1914,621,East,99,1737,336,Furniture,1293
03-04-2023 11:00,4747,580,West,75,1147,560,Electronics,4167
03-04-2023 12:00,4040,2922,East,90,747,420,Furniture,1118
03-04-2023 13:00,2462,2610,South,87,1931,199,Furniture,-148
03-04-2023 14:00,3289,1003,East,69,1576,839,Electronics,2286
03-04-2023 15:00,1580,1167,East,51,813,789,Electronics,413
03-04-2023 16:00,3734,2996,North,75,1897,507,Groceries,738
03-04-2023 17:00,2584,1944,North,85,536,254,Electronics,640
03-04-2023 18:00,1482,1845,South,74,1223,533,Electronics,-363
03-04-2023 19:00,4179,1689,East,79,1479,850,Clothing,2490
03-04-2023 20:00,2249,2120,North,67,583,533,Furniture,129
03-04-2023 21:00,1672,2480,East,56,1399,242,Furniture,-808
03-04-2023 22:00,1630,2172,West,76,1617,628,Groceries,-542
03-04-2023 23:00,3708,958,West,60,1938,384,Clothing,2750
04-04-2023 00:00,1661,1712,South,86,1865,104,Groceries,-51
04-04-2023 01:00,4503,963,West,57,1218,622,Electronics,3540
04-04-2023 02:00,3852,1411,North,60,1049,819,Groceries,2441
04-04-2023 03:00,4726,2926,North,73,1944,535,Furniture,1800
04-04-2023 04:00,3466,1525,South,79,1871,517,Clothing,1941
04-04-2023 05:00,1987,2911,East,79,1214,180,Electronics,-924
04-04-2023 06:00,4526,571,North,64,1086,644,Clothing,3955
04-04-2023 07:00,4231,1950,West,84,1651,916,Clothing,2281
04-04-2023 08:00,2546,1693,North,88,651,476,Groceries,853
04-04-2023 09:00,1649,2348,South,73,1561,258,Electronics,-699
04-04-2023 10:00,1968,2884,West,57,1950,885,Clothing,-916
04-04-2023 11:00,3637,2522,West,92,1628,726,Clothing,1115
04-04-2023 12:00,2100,2742,West,91,664,316,Groceries,-642
04-04-2023 13:00,3556,1511,South,69,1437,872,Clothing,2045
04-04-2023 14:00,1440,1152,South,90,711,769,Furniture,288
04-04-2023 15:00,4325,1798,East,96,1025,144,Furniture,2527
04-04-2023 16:00,1920,506,East,75,1241,731,Electronics,1414
04-04-2023 17:00,1769,1404,East,73,631,314,Electronics,365
04-04-2023 18:00,2343,2528,South,71,1675,610,Groceries,-185
04-04-2023 19:00,2826,1115,West,54,595,227,Clothing,1711
04-04-2023 20:00,1262,2373,West,64,1512,353,Groceries,-1111
04-04-2023 21:00,4668,1269,North,85,1021,649,Groceries,3399
04-04-2023 22:00,4729,2789,East,86,873,976,Furniture,1940
04-04-2023 23:00,4906,2066,West,78,1539,821,Clothing,2840
05-04-2023 00:00,2577,1985,West,64,1107,451,Furniture,592
05-04-2023 01:00,4445,1940,West,76,517,705,Furniture,2505
05-04-2023 02:00,3684,1265,West,98,1932,640,Electronics,2419
05-04-2023 03:00,4238,883,South,57,1530,263,Groceries,3355
05-04-2023 04:00,4824,2938,East,78,1768,748,Furniture,1886
05-04-2023 05:00,3506,1187,West,68,1477,634,Electronics,2319
05-04-2023 06:00,1998,1649,West,80,1378,230,Electronics,349
05-04-2023 07:00,4351,546,West,58,1093,697,Clothing,3805
05-04-2023 08:00,1699,2472,West,59,1142,795,Clothing,-773
05-04-2023 09:00,3349,963,North,86,628,603,Furniture,2386
05-04-2023 10:00,4602,2372,West,59,1300,523,Electronics,2230
05-04-2023 11:00,2603,622,West,82,954,848,Electronics,1981
05-04-2023 12:00,2241,2681,West,74,1375,283,Electronics,-440
05-04-2023 13:00,2125,2142,North,53,1070,925,Groceries,-17
05-04-2023 14:00,3601,1340,South,54,1595,770,Electronics,2261
05-04-2023 15:00,3335,2085,North,72,1513,622,Groceries,1250
05-04-2023 16:00,2190,2303,West,88,1683,653,Clothing,-113
05-04-2023 17:00,3668,522,South,54,1610,334,Furniture,3146
05-04-2023 18:00,2005,1065,West,57,900,230,Clothing,940
05-04-2023 19:00,1035,2409,South,66,961,796,Furniture,-1374
05-04-2023 20:00,1743,1464,West,50,588,113,Electronics,279
05-04-2023 21:00,2764,2782,West,99,1322,913,Furniture,-18
05-04-2023 22:00,1352,1495,South,61,505,865,Furniture,-143
05-04-2023 23:00,4747,1687,South,84,1444,758,Clothing,3060
06-04-2023 00:00,2922,2294,West,63,583,479,Furniture,628
06-04-2023 01:00,1072,1325,North,97,1773,159,Electronics,-253
06-04-2023 02:00,3695,715,North,67,1939,391,Groceries,2980
06-04-2023 03:00,2376,1156,North,59,1595,259,Electronics,1220
06-04-2023 04:00,2914,1613,North,64,1120,546,Furniture,1301
06-04-2023 05:00,2093,2487,South,91,1635,637,Clothing,-394
06-04-2023 06:00,3472,810,South,82,671,676,Electronics,2662
06-04-2023 07:00,4046,1056,North,68,1198,485,Furniture,2990
06-04-2023 08:00,1707,2804,East,83,772,169,Clothing,-1097
06-04-2023 09:00,2804,2056,East,94,1029,481,Groceries,748
06-04-2023 10:00,3608,551,East,74,818,784,Clothing,3057
06-04-2023 11:00,3875,1861,West,65,1605,324,Furniture,2014
06-04-2023 12:00,4713,1694,North,57,1598,607,Clothing,3019
06-04-2023 13:00,1955,2148,West,84,928,764,Furniture,-193
06-04-2023 14:00,3564,2847,South,70,1983,139,Clothing,717
06-04-2023 15:00,3475,1171,South,68,1346,245,Clothing,2304
06-04-2023 16:00,4610,1277,East,95,1869,465,Clothing,3333
06-04-2023 17:00,1159,1331,East,60,748,709,Furniture,-172
06-04-2023 18:00,3196,2779,South,93,886,347,Clothing,417
06-04-2023 19:00,3823,2360,East,60,862,111,Furniture,1463
06-04-2023 20:00,4301,2029,East,60,1819,635,Electronics,2272
06-04-2023 21:00,2735,2575,South,71,567,836,Groceries,160
06-04-2023 22:00,2585,2472,West,70,937,609,Electronics,113
06-04-2023 23:00,1066,1574,East,76,1515,344,Groceries,-508
07-04-2023 00:00,4061,2216,West,67,1656,270,Furniture,1845
07-04-2023 01:00,4883,1783,East,91,1818,131,Electronics,3100
07-04-2023 02:00,3428,1090,North,97,795,725,Groceries,2338
07-04-2023 03:00,1057,2486,West,89,1146,820,Groceries,-1429
07-04-2023 04:00,4330,1501,West,87,532,914,Electronics,2829
07-04-2023 05:00,1341,2731,East,79,1897,528,Electronics,-1390
07-04-2023 06:00,4909,1546,West,94,531,134,Furniture,3363
07-04-2023 07:00,2153,2676,North,96,1054,304,Groceries,-523
07-04-2023 08:00,3774,2838,South,94,804,989,Furniture,936
07-04-2023 09:00,2195,2355,North,82,1292,483,Furniture,-160
07-04-2023 10:00,3817,1000,South,70,1631,365,Clothing,2817
07-04-2023 11:00,3661,2733,North,51,595,676,Furniture,928
07-04-2023 12:00,2232,978,North,62,1589,542,Groceries,1254
07-04-2023 13:00,4874,2094,West,51,1020,709,Clothing,2780
07-04-2023 14:00,3401,1012,North,92,729,796,Furniture,2389
07-04-2023 15:00,2494,2832,East,94,1232,849,Furniture,-338
07-04-2023 16:00,2821,1100,East,80,857,584,Groceries,1721
07-04-2023 17:00,1115,1940,East,59,901,569,Clothing,-825
07-04-2023 18:00,4335,1623,East,72,1289,365,Electronics,2712
07-04-2023 19:00,1661,688,West,71,598,843,Electronics,973
07-04-2023 20:00,4883,1488,East,96,770,208,Clothing,3395
07-04-2023 21:00,2465,2381,North,78,861,588,Clothing,84
07-04-2023 22:00,4619,887,East,82,1687,277,Clothing,3732
07-04-2023 23:00,3500,2788,West,80,1027,348,Clothing,712
08-04-2023 00:00,2868,2305,South,63,1692,935,Electronics,563
08-04-2023 01:00,4548,2533,North,59,1544,971,Furniture,2015
08-04-2023 02:00,3334,2254,North,67,1039,104,Groceries,1080
08-04-2023 03:00,4374,2964,West,60,1094,256,Electronics,1410
08-04-2023 04:00,2016,2723,South,88,1332,329,Groceries,-707
08-04-2023 05:00,1310,886,East,96,896,727,Electronics,424
08-04-2023 06:00,1207,1994,South,52,1559,360,Clothing,-787
08-04-2023 07:00,3665,1352,North,51,994,927,Electronics,2313
08-04-2023 08:00,3493,951,North,57,813,420,Electronics,2542
08-04-2023 09:00,3717,2824,North,80,989,226,Clothing,893
08-04-2023 10:00,1632,2258,South,57,1799,127,Furniture,-626
08-04-2023 11:00,3102,712,East,92,732,950,Clothing,2390
08-04-2023 12:00,3959,540,North,97,1959,609,Furniture,3419
08-04-2023 13:00,4083,1645,West,51,1529,327,Electronics,2438
08-04-2023 14:00,1656,2841,East,71,1163,740,Electronics,-1185
08-04-2023 15:00,2423,1099,North,54,743,640,Groceries,1324
08-04-2023 16:00,2931,2524,East,56,740,278,Groceries,407
08-04-2023 17:00,4719,2530,West,69,1057,775,Electronics,2189
08-04-2023 18:00,4027,2282,South,77,1796,771,Groceries,1745
08-04-2023 19:00,3562,2351,North,62,574,931,Furniture,1211
08-04-2023 20:00,2679,2998,West,51,782,387,Clothing,-319
08-04-2023 21:00,4613,2279,North,81,586,593,Electronics,2334
08-04-2023 22:00,1236,2881,North,75,1380,364,Electronics,-1645
08-04-2023 23:00,4350,2404,South,52,1429,566,Groceries,1946
09-04-2023 00:00,1347,2591,South,90,1672,494,Electronics,-1244
09-04-2023 01:00,3674,643,East,91,1673,531,Electronics,3031
09-04-2023 02:00,4175,832,West,62,659,534,Furniture,3343
09-04-2023 03:00,1629,1497,West,70,945,487,Furniture,132
09-04-2023 04:00,2540,1919,South,94,581,908,Clothing,621
09-04-2023 05:00,3003,554,North,86,1530,636,Electronics,2449
09-04-2023 06:00,4943,1830,East,72,681,244,Groceries,3113
09-04-2023 07:00,2271,1946,South,56,1369,274,Clothing,325
09-04-2023 08:00,1363,1940,East,66,1465,619,Groceries,-577
09-04-2023 09:00,3368,2872,East,77,977,413,Electronics,496
09-04-2023 10:00,4704,2233,West,96,682,720,Groceries,2471
09-04-2023 11:00,1285,2194,East,79,1837,228,Groceries,-909
09-04-2023 12:00,1148,579,West,54,673,613,Clothing,569
09-04-2023 13:00,2107,1484,North,73,513,109,Electronics,623
09-04-2023 14:00,3453,1364,North,56,1823,446,Clothing,2089
09-04-2023 15:00,4025,2087,South,83,572,216,Electronics,1938
09-04-2023 16:00,1455,971,North,99,1013,510,Furniture,484
09-04-2023 17:00,2766,2621,West,91,1101,496,Clothing,145
09-04-2023 18:00,1799,2076,East,82,842,930,Electronics,-277
09-04-2023 19:00,2184,2002,East,76,1919,110,Furniture,182
09-04-2023 20:00,2012,1088,North,63,832,497,Furniture,924
09-04-2023 21:00,3831,1910,West,68,854,707,Furniture,1921
09-04-2023 22:00,3507,2405,East,97,1346,991,Clothing,1102
09-04-2023 23:00,4621,1063,North,87,662,192,Furniture,3558
10-04-2023 00:00,2523,966,West,61,615,201,Electronics,1557
10-04-2023 01:00,3785,1098,West,52,1926,197,Clothing,2687
10-04-2023 02:00,3556,2144,East,56,1602,381,Groceries,1412
10-04-2023 03:00,4725,1491,South,84,1970,906,Furniture,3234
10-04-2023 04:00,4875,2432,South,74,1531,959,Clothing,2443
10-04-2023 05:00,1480,2795,West,98,1546,767,Groceries,-1315
10-04-2023 06:00,2686,2104,West,64,1290,756,Clothing,582
10-04-2023 07:00,3161,566,North,68,1042,520,Furniture,2595
10-04-2023 08:00,3796,969,West,68,913,463,Furniture,2827
10-04-2023 09:00,2601,2224,North,72,1181,310,Groceries,377
10-04-2023 10:00,3408,2833,North,60,1141,766,Electronics,575
10-04-2023 11:00,1340,2131,North,70,1932,853,Furniture,-791
10-04-2023 12:00,3817,2859,West,83,1168,607,Groceries,958
10-04-2023 13:00,3010,2856,West,88,521,175,Furniture,154
10-04-2023 14:00,3808,1274,North,56,1926,422,Electronics,2534
10-04-2023 15:00,4016,1636,East,91,1468,989,Groceries,2380
10-04-2023 16:00,3496,2511,West,93,1680,551,Electronics,985
10-04-2023 17:00,2866,1986,South,76,829,786,Furniture,880
10-04-2023 18:00,1834,631,East,99,1545,722,Groceries,1203
10-04-2023 19:00,2203,1429,South,72,1995,117,Clothing,774
10-04-2023 20:00,2725,1428,West,87,1787,390,Electronics,1297
10-04-2023 21:00,4478,2668,East,69,1826,885,Furniture,1810
10-04-2023 22:00,2689,1720,West,76,1401,849,Furniture,969
10-04-2023 23:00,4267,2005,West,57,1223,297,Electronics,2262
11-04-2023 00:00,4537,1133,East,86,1988,261,Groceries,3404
11-04-2023 01:00,1310,1562,West,52,1687,516,Clothing,-252
11-04-2023 02:00,1261,1684,East,51,1659,483,Furniture,-423
11-04-2023 03:00,2442,788,West,71,751,299,Electronics,1654
11-04-2023 04:00,1405,2747,North,55,704,845,Electronics,-1342
11-04-2023 05:00,3190,2311,South,88,1825,994,Clothing,879
11-04-2023 06:00,1341,1027,North,89,1765,951,Clothing,314
11-04-2023 07:00,2339,1416,West,85,1331,597,Furniture,923
11-04-2023 08:00,4172,2208,West,93,1290,142,Clothing,1964
11-04-2023 09:00,1243,1906,West,73,1584,181,Electronics,-663
11-04-2023 10:00,1489,1741,North,61,964,638,Groceries,-252
11-04-2023 11:00,1011,1610,West,66,1825,403,Groceries,-599
11-04-2023 12:00,4310,1298,East,71,1995,680,Electronics,3012
11-04-2023 13:00,1560,2023,South,68,893,298,Electronics,-463
11-04-2023 14:00,1041,511,West,58,1520,505,Electronics,530
11-04-2023 15:00,3725,1332,West,61,1159,526,Furniture,2393
11-04-2023 16:00,1593,1741,South,81,1411,560,Electronics,-148
11-04-2023 17:00,2452,2172,South,80,1782,983,Clothing,280
11-04-2023 18:00,2826,2653,South,66,1029,579,Electronics,173
11-04-2023 19:00,4229,1190,North,72,1710,827,Electronics,3039
11-04-2023 20:00,4287,1027,North,59,1735,223,Furniture,3260
11-04-2023 21:00,2693,1995,West,79,1558,627,Electronics,698
11-04-2023 22:00,4533,1392,South,68,1670,737,Clothing,3141
11-04-2023 23:00,1133,886,West,75,1805,625,Clothing,247
12-04-2023 00:00,4138,1749,West,75,1772,138,Clothing,2389
12-04-2023 01:00,4919,2277,West,60,556,298,Electronics,2642
12-04-2023 02:00,4078,907,North,69,1828,207,Furniture,3171
12-04-2023 03:00,1947,2176,South,94,1021,367,Furniture,-229
12-04-2023 04:00,4597,1397,West,53,860,452,Furniture,3200
12-04-2023 05:00,1072,1210,North,96,1760,410,Clothing,-138
12-04-2023 06:00,1398,2182,East,61,733,489,Furniture,-784
12-04-2023 07:00,2428,1417,East,74,722,139,Electronics,1011
12-04-2023 08:00,4746,2750,West,59,826,958,Electronics,1996
12-04-2023 09:00,3625,916,West,71,1621,880,Groceries,2709
12-04-2023 10:00,3906,915,South,56,1749,680,Clothing,2991
12-04-2023 11:00,1129,1971,South,73,1335,251,Groceries,-842
12-04-2023 12:00,3978,2035,West,51,988,286,Groceries,1943
12-04-2023 13:00,4537,584,North,81,977,529,Clothing,3953
12-04-2023 14:00,4277,666,West,70,1484,963,Clothing,3611
12-04-2023 15:00,2811,2931,South,56,1857,556,Groceries,-120
12-04-2023 16:00,3001,1595,South,57,1291,852,Electronics,1406
12-04-2023 17:00,4839,1309,North,87,1011,326,Groceries,3530
12-04-2023 18:00,1265,2044,West,70,1512,527,Clothing,-779
12-04-2023 19:00,2560,2316,South,57,881,303,Electronics,244
12-04-2023 20:00,2985,1492,West,74,1946,878,Groceries,1493
12-04-2023 21:00,1792,1781,South,77,1871,217,Groceries,11
12-04-2023 22:00,3300,774,East,77,1676,928,Groceries,2526
12-04-2023 23:00,3869,2273,East,80,951,903,Clothing,1596
13-04-2023 00:00,2312,2256,East,85,1813,493,Groceries,56
13-04-2023 01:00,1163,2873,South,74,1642,321,Clothing,-1710
13-04-2023 02:00,1094,1391,North,90,713,996,Electronics,-297
13-04-2023 03:00,2805,588,East,86,1064,162,Furniture,2217
13-04-2023 04:00,3880,1207,South,87,1231,495,Electronics,2673
13-04-2023 05:00,2133,2897,West,61,938,104,Groceries,-764
13-04-2023 06:00,3383,886,East,86,1254,433,Clothing,2497
13-04-2023 07:00,1821,2634,North,86,1128,391,Groceries,-813
13-04-2023 08:00,1237,2854,North,80,1402,607,Electronics,-1617
13-04-2023 09:00,3428,2373,North,67,1970,244,Furniture,1055
13-04-2023 10:00,4507,1677,West,75,1565,761,Furniture,2830
13-04-2023 11:00,3946,939,West,55,894,258,Clothing,3007
13-04-2023 12:00,3530,2811,North,58,746,880,Electronics,719
13-04-2023 13:00,2960,1476,North,60,1404,930,Electronics,1484
13-04-2023 14:00,3949,1234,North,80,1814,110,Clothing,2715
13-04-2023 15:00,2048,2968,West,95,747,168,Clothing,-920
13-04-2023 16:00,2676,1132,West,51,1098,803,Clothing,1544
13-04-2023 17:00,4188,1492,South,78,1364,713,Groceries,2696
13-04-2023 18:00,3529,2958,East,95,1972,643,Groceries,571
13-04-2023 19:00,4463,672,West,91,583,301,Clothing,3791
13-04-2023 20:00,3964,503,North,54,1272,365,Clothing,3461
13-04-2023 21:00,4041,2163,East,72,1744,207,Furniture,1878
13-04-2023 22:00,1963,2515,West,85,550,153,Furniture,-552
13-04-2023 23:00,1536,1995,East,56,1049,437,Groceries,-459
14-04-2023 00:00,4150,1560,South,62,1270,289,Furniture,2590
14-04-2023 01:00,2603,1554,West,91,1480,338,Clothing,1049
14-04-2023 02:00,4244,880,North,59,1710,442,Electronics,3364
14-04-2023 03:00,2979,1791,North,85,1746,949,Clothing,1188
14-04-2023 04:00,4083,2891,South,65,964,390,Furniture,1192
14-04-2023 05:00,4871,2092,South,64,918,422,Groceries,2779
14-04-2023 06:00,1127,665,South,92,586,420,Clothing,462
14-04-2023 07:00,4679,2889,South,68,758,884,Clothing,1790
14-04-2023 08:00,1091,1542,South,70,1704,141,Furniture,-451
14-04-2023 09:00,4724,2151,West,84,810,297,Electronics,2573
14-04-2023 10:00,1542,1707,West,64,672,988,Clothing,-165
14-04-2023 11:00,1845,1044,East,97,1845,732,Groceries,801
14-04-2023 12:00,4603,2739,South,63,1863,945,Groceries,1864
14-04-2023 13:00,2681,2867,North,78,1768,383,Electronics,-186
14-04-2023 14:00,4036,2974,North,54,1439,906,Furniture,1062
14-04-2023 15:00,2851,596,South,98,1004,281,Electronics,2255
14-04-2023 16:00,3494,1801,South,67,828,711,Groceries,1693
14-04-2023 17:00,1389,2556,South,50,695,110,Clothing,-1167
14-04-2023 18:00,3719,956,South,76,561,982,Groceries,2763
14-04-2023 19:00,2884,2318,South,76,1548,844,Electronics,566
14-04-2023 20:00,1042,772,North,74,1061,541,Groceries,270
14-04-2023 21:00,1253,1531,East,90,1901,728,Furniture,-278
14-04-2023 22:00,4201,707,South,70,1396,523,Electronics,3494
14-04-2023 23:00,2083,2437,South,63,1818,599,Groceries,-354
15-04-2023 00:00,3710,2160,South,69,1575,487,Clothing,1550
15-04-2023 01:00,3514,1646,West,77,1343,675,Clothing,1868
15-04-2023 02:00,3334,1556,North,70,539,787,Electronics,1778
15-04-2023 03:00,4058,2036,North,72,1227,553,Clothing,2022
15-04-2023 04:00,2540,703,East,60,956,694,Electronics,1837
15-04-2023 05:00,4538,2332,West,51,1377,101,Clothing,2206
15-04-2023 06:00,2953,942,West,69,1287,910,Groceries,2011
15-04-2023 07:00,3825,1188,West,73,501,828,Clothing,2637
15-04-2023 08:00,3392,1332,East,74,1992,341,Groceries,2060
15-04-2023 09:00,1641,2886,East,86,1629,908,Electronics,-1245
15-04-2023 10:00,3429,1961,East,71,715,159,Clothing,1468
15-04-2023 11:00,4850,1659,West,73,1276,467,Furniture,3191
15-04-2023 12:00,1689,886,North,64,1178,814,Furniture,803
15-04-2023 13:00,2276,2541,West,61,913,139,Furniture,-265
15-04-2023 14:00,2950,1848,East,95,709,414,Clothing,1102
15-04-2023 15:00,2079,2218,West,80,1581,656,Groceries,-139
15-04-2023 16:00,2486,1179,South,92,542,397,Electronics,1307
15-04-2023 17:00,1456,1189,West,80,637,730,Clothing,267
15-04-2023 18:00,1982,2068,West,79,1137,742,Electronics,-86
15-04-2023 19:00,3130,1669,North,90,968,549,Electronics,1461
15-04-2023 20:00,4976,1392,North,69,1225,494,Clothing,3584
15-04-2023 21:00,2122,1452,North,57,1912,891,Groceries,670
15-04-2023 22:00,1148,1754,South,93,1721,661,Furniture,-606
15-04-2023 23:00,2352,1283,North,79,701,187,Electronics,1069
16-04-2023 00:00,2179,2546,South,84,691,632,Electronics,-367
16-04-2023 01:00,1189,2371,East,70,606,487,Clothing,-1182
16-04-2023 02:00,4565,994,North,96,826,843,Electronics,3571
16-04-2023 03:00,1882,1246,West,89,1249,480,Clothing,636
16-04-2023 04:00,3310,2984,West,77,1143,654,Electronics,326
16-04-2023 05:00,4151,2354,South,88,856,530,Groceries,1797
16-04-2023 06:00,1399,2892,North,66,1094,634,Groceries,-1493
16-04-2023 07:00,3811,2691,West,61,1000,315,Furniture,1120
16-04-2023 08:00,1608,1156,East,99,1807,376,Furniture,452
16-04-2023 09:00,4331,2382,North,67,967,293,Groceries,1949
16-04-2023 10:00,2795,2892,East,96,1007,826,Furniture,-97
16-04-2023 11:00,2638,2296,West,77,605,278,Furniture,342
16-04-2023 12:00,2575,767,North,52,1817,242,Furniture,1808
16-04-2023 13:00,3832,2716,South,64,1589,925,Groceries,1116
16-04-2023 14:00,3148,2262,West,65,694,637,Furniture,886
16-04-2023 15:00,2382,2580,East,71,1711,317,Clothing,-198
16-04-2023 16:00,2403,876,North,98,546,610,Furniture,1527
16-04-2023 17:00,1819,2085,East,80,1885,158,Clothing,-266
16-04-2023 18:00,4292,1963,East,80,1508,445,Furniture,2329
16-04-2023 19:00,1819,2940,South,50,1036,656,Clothing,-1121
16-04-2023 20:00,1419,988,South,60,1346,518,Furniture,431
16-04-2023 21:00,1123,1221,West,55,1208,323,Clothing,-98
16-04-2023 22:00,1421,1445,South,72,1769,449,Furniture,-24
16-04-2023 23:00,4302,2586,South,58,1307,867,Clothing,1716
17-04-2023 00:00,4761,2135,West,65,1111,721,Groceries,2626
17-04-2023 01:00,4134,1540,West,87,1701,931,Electronics,2594
17-04-2023 02:00,2508,2773,West,93,614,951,Electronics,-265
17-04-2023 03:00,4699,2614,West,68,1179,861,Groceries,2085
17-04-2023 04:00,4774,2177,East,94,1130,176,Groceries,2597
17-04-2023 05:00,2597,1498,East,62,1688,894,Clothing,1099
17-04-2023 06:00,1767,2277,West,81,718,698,Clothing,-510
17-04-2023 07:00,3044,2784,West,85,696,861,Furniture,260
17-04-2023 08:00,3530,1456,North,58,900,307,Furniture,2074
17-04-2023 09:00,3566,2089,North,95,1248,258,Electronics,1477
17-04-2023 10:00,3202,1661,North,95,1180,623,Electronics,1541
17-04-2023 11:00,3139,2368,South,98,575,324,Clothing,771
17-04-2023 12:00,4029,1052,East,86,1949,457,Clothing,2977
17-04-2023 13:00,2549,2133,East,80,786,912,Groceries,416
17-04-2023 14:00,3502,1194,North,80,1822,483,Clothing,2308
17-04-2023 15:00,2764,816,North,68,1360,643,Furniture,1948
17-04-2023 16:00,3044,1267,East,51,1241,665,Groceries,1777
17-04-2023 17:00,3645,2471,South,94,793,603,Clothing,1174
17-04-2023 18:00,4716,2805,North,81,1308,549,Furniture,1911
17-04-2023 19:00,1509,2003,West,92,1385,341,Furniture,-494
17-04-2023 20:00,2206,622,North,83,1970,468,Electronics,1584
17-04-2023 21:00,1385,2889,East,50,913,726,Groceries,-1504
17-04-2023 22:00,2597,2368,East,70,930,570,Electronics,229
17-04-2023 23:00,4802,2171,North,52,1753,387,Groceries,2631
18-04-2023 00:00,3452,1582,North,76,1619,498,Groceries,1870
18-04-2023 01:00,3293,2228,West,93,1962,203,Electronics,1065
18-04-2023 02:00,1741,2807,West,56,670,410,Electronics,-1066
18-04-2023 03:00,4662,2496,South,82,1840,908,Clothing,2166
18-04-2023 04:00,3708,2642,South,58,1043,226,Groceries,1066
18-04-2023 05:00,3697,1648,West,79,1911,139,Clothing,2049
18-04-2023 06:00,4542,2588,South,67,1488,171,Groceries,1954
18-04-2023 07:00,4897,2414,South,75,571,846,Furniture,2483
18-04-2023 08:00,2911,753,North,69,1522,981,Clothing,2158
18-04-2023 09:00,2446,506,West,87,1031,346,Electronics,1940
18-04-2023 10:00,1900,2616,North,90,738,905,Furniture,-716
18-04-2023 11:00,3112,1041,North,80,1210,346,Electronics,2071
18-04-2023 12:00,4084,588,South,57,1076,411,Furniture,3496
18-04-2023 13:00,3260,2438,North,72,1612,133,Furniture,822
18-04-2023 14:00,3009,712,East,99,1212,228,Clothing,2297
18-04-2023 15:00,1241,765,South,74,1141,109,Electronics,476
18-04-2023 16:00,3540,2840,East,96,1677,267,Clothing,700
18-04-2023 17:00,4284,1730,South,50,1089,883,Furniture,2554
18-04-2023 18:00,4764,2880,North,95,689,315,Groceries,1884
18-04-2023 19:00,3385,1504,South,67,1311,507,Groceries,1881
18-04-2023 20:00,3020,2594,East,68,1938,851,Furniture,426
18-04-2023 21:00,1172,1121,South,91,1677,625,Electronics,51
18-04-2023 22:00,1671,926,East,55,1514,701,Electronics,745
18-04-2023 23:00,1163,709,West,66,1124,117,Electronics,454
19-04-2023 00:00,1464,1387,North,95,1862,439,Groceries,77
19-04-2023 01:00,4042,1943,East,94,1128,780,Clothing,2099
19-04-2023 02:00,1496,653,West,57,1388,667,Electronics,843
19-04-2023 03:00,1699,914,North,91,1558,775,Clothing,785
19-04-2023 04:00,3442,1680,West,58,1283,763,Electronics,1762
19-04-2023 05:00,1702,1784,East,86,1170,189,Electronics,-82
19-04-2023 06:00,2940,1268,North,76,1221,384,Electronics,1672
19-04-2023 07:00,3355,1482,West,85,1025,633,Clothing,1873
19-04-2023 08:00,2791,2011,East,55,1036,366,Clothing,780
19-04-2023 09:00,1182,1078,West,55,1346,908,Clothing,104
19-04-2023 10:00,1628,2710,North,94,1741,532,Furniture,-1082
19-04-2023 11:00,4865,1538,North,53,1777,857,Groceries,3327
19-04-2023 12:00,3557,2742,North,71,1495,750,Furniture,815
19-04-2023 13:00,2731,1041,East,89,1726,151,Groceries,1690
19-04-2023 14:00,1545,858,West,76,1624,166,Furniture,687
19-04-2023 15:00,2587,1349,West,86,1884,696,Groceries,1238
19-04-2023 16:00,1623,926,East,51,1413,349,Clothing,697
19-04-2023 17:00,4835,985,North,58,677,430,Groceries,3850
19-04-2023 18:00,1593,2331,South,60,775,514,Electronics,-738
19-04-2023 19:00,1743,1972,North,69,811,222,Clothing,-229
19-04-2023 20:00,4298,1936,South,92,1933,301,Furniture,2362
19-04-2023 21:00,2768,829,North,88,1290,105,Electronics,1939
19-04-2023 22:00,4804,2255,East,63,1811,948,Electronics,2549
19-04-2023 23:00,2459,1670,South,75,1924,585,Clothing,789
20-04-2023 00:00,2948,758,East,87,1740,298,Electronics,2190
20-04-2023 01:00,4493,2839,South,79,1197,835,Clothing,1654
20-04-2023 02:00,3601,642,West,85,1993,112,Groceries,2959
20-04-2023 03:00,3068,2516,South,87,526,105,Clothing,552
20-04-2023 04:00,3601,1126,South,84,1412,510,Clothing,2475
20-04-2023 05:00,3444,1888,South,55,921,220,Furniture,1556
20-04-2023 06:00,3672,589,West,52,1537,656,Electronics,3083
20-04-2023 07:00,1104,1219,East,50,1000,461,Furniture,-115
20-04-2023 08:00,3239,980,West,67,1407,637,Furniture,2259
20-04-2023 09:00,1016,2631,South,72,824,103,Furniture,-1615
20-04-2023 10:00,4191,1600,North,81,1847,904,Furniture,2591
20-04-2023 11:00,1392,1172,West,78,784,888,Furniture,220
20-04-2023 12:00,1424,1016,North,72,1612,383,Electronics,408
20-04-2023 13:00,3176,2113,West,85,1568,821,Electronics,1063
20-04-2023 14:00,4201,1281,West,55,997,899,Electronics,2920
20-04-2023 15:00,1571,2651,South,66,1411,458,Furniture,-1080
20-04-2023 16:00,4631,2535,East,67,644,792,Electronics,2096
20-04-2023 17:00,3076,2886,East,80,1447,864,Furniture,190
20-04-2023 18:00,2120,1186,South,55,581,381,Electronics,934
20-04-2023 19:00,4081,2089,West,83,1479,756,Electronics,1992
20-04-2023 20:00,1241,1399,East,93,1690,727,Electronics,-158
20-04-2023 21:00,4897,2001,East,93,1628,448,Electronics,2896
20-04-2023 22:00,3279,722,East,76,987,129,Clothing,2557
20-04-2023 23:00,1788,1576,South,85,1833,988,Electronics,212
21-04-2023 00:00,4355,1600,North,97,581,853,Electronics,2755
21-04-2023 01:00,1714,2241,North,91,593,616,Clothing,-527
21-04-2023 02:00,1758,1002,North,74,1844,473,Groceries,756
21-04-2023 03:00,3849,1839,North,59,842,873,Groceries,2010
21-04-2023 04:00,1775,1123,North,88,1296,717,Clothing,652
21-04-2023 05:00,3773,2386,East,95,860,223,Groceries,1387
21-04-2023 06:00,3247,2712,East,88,1589,545,Electronics,535
21-04-2023 07:00,3992,1550,West,61,1123,493,Furniture,2442
21-04-2023 08:00,1078,1593,East,60,1367,937,Furniture,-515
21-04-2023 09:00,4984,2485,South,98,928,749,Electronics,2499
21-04-2023 10:00,4003,1888,West,92,1924,717,Electronics,2115
21-04-2023 11:00,4926,1829,East,52,670,824,Groceries,3097
21-04-2023 12:00,1855,1647,West,71,1077,911,Clothing,208
21-04-2023 13:00,4244,518,West,53,567,155,Furniture,3726
21-04-2023 14:00,3514,1780,North,57,1557,231,Electronics,1734
21-04-2023 15:00,3628,1545,West,63,500,880,Clothing,2083
21-04-2023 16:00,2439,1488,East,69,650,221,Clothing,951
21-04-2023 17:00,3987,2997,North,73,1401,301,Electronics,990
21-04-2023 18:00,3496,2073,East,63,757,819,Clothing,1423
21-04-2023 19:00,3134,1571,North,77,1249,886,Furniture,1563
21-04-2023 20:00,3148,1706,East,65,1127,701,Furniture,1442
21-04-2023 21:00,2031,1958,North,81,1294,801,Clothing,73
21-04-2023 22:00,1844,2654,North,96,518,364,Electronics,-810
21-04-2023 23:00,4271,1711,South,61,534,657,Clothing,2560
22-04-2023 00:00,4576,1275,East,65,870,923,Groceries,3301
22-04-2023 01:00,1086,2359,West,68,990,941,Electronics,-1273
22-04-2023 02:00,3090,2366,North,54,1316,139,Electronics,724
22-04-2023 03:00,4456,1660,East,61,1764,678,Electronics,2796
22-04-2023 04:00,4692,2381,North,78,506,212,Furniture,2311
22-04-2023 05:00,4506,2883,South,54,1048,438,Electronics,1623
22-04-2023 06:00,1407,2280,South,91,870,161,Electronics,-873
22-04-2023 07:00,4554,1101,South,66,1256,326,Furniture,3453
22-04-2023 08:00,3711,2094,South,96,1773,273,Furniture,1617
22-04-2023 09:00,4088,2950,West,57,1638,233,Furniture,1138
22-04-2023 10:00,2668,1039,West,89,1860,384,Electronics,1629
22-04-2023 11:00,1147,1595,North,89,1073,886,Electronics,-448
22-04-2023 12:00,3324,2305,East,79,1180,725,Furniture,1019
22-04-2023 13:00,1231,523,South,59,1665,207,Furniture,708
22-04-2023 14:00,4897,1123,South,69,1961,242,Groceries,3774
22-04-2023 15:00,2950,2335,West,94,587,668,Furniture,615
22-04-2023 16:00,1365,1579,West,65,962,393,Clothing,-214
22-04-2023 17:00,4299,1485,South,90,1571,376,Groceries,2814
22-04-2023 18:00,2674,722,East,65,980,591,Furniture,1952
22-04-2023 19:00,1435,678,North,91,1322,662,Furniture,757
22-04-2023 20:00,1398,2981,North,52,1023,570,Furniture,-1583
22-04-2023 21:00,2234,2460,North,72,710,375,Furniture,-226
22-04-2023 22:00,2414,1973,North,71,743,333,Clothing,441
22-04-2023 23:00,3546,1292,East,77,738,341,Furniture,2254
23-04-2023 00:00,3587,1383,East,95,1720,357,Electronics,2204
23-04-2023 01:00,1562,1712,East,94,1268,848,Groceries,-150
23-04-2023 02:00,4562,2101,West,85,734,131,Furniture,2461
23-04-2023 03:00,3489,1309,South,53,686,466,Electronics,2180
23-04-2023 04:00,2284,1460,East,87,1212,447,Clothing,824
23-04-2023 05:00,1772,919,North,73,1813,859,Groceries,853
23-04-2023 06:00,3397,1687,East,68,1744,231,Furniture,1710
23-04-2023 07:00,3037,1778,South,60,996,874,Groceries,1259
23-04-2023 08:00,4423,1940,West,89,1825,870,Furniture,2483
23-04-2023 09:00,3567,2717,North,95,686,892,Clothing,850
23-04-2023 10:00,2343,1840,West,89,1973,467,Clothing,503
23-04-2023 11:00,3185,2721,East,95,1935,861,Groceries,464
23-04-2023 12:00,2573,2892,North,88,1435,364,Groceries,-319
23-04-2023 13:00,4694,2992,North,67,1768,314,Groceries,1702
23-04-2023 14:00,1991,1541,East,61,812,314,Clothing,450
23-04-2023 15:00,3415,1593,East,63,1318,381,Electronics,1822
23-04-2023 16:00,4291,1861,South,96,521,931,Groceries,2430
23-04-2023 17:00,4408,1091,East,67,567,629,Furniture,3317
23-04-2023 18:00,2246,1026,East,93,891,958,Clothing,1220
23-04-2023 19:00,4719,1792,East,91,1839,101,Groceries,2927
23-04-2023 20:00,4839,2154,North,61,1588,612,Clothing,2685
23-04-2023 21:00,1359,1310,South,89,1228,915,Groceries,49
23-04-2023 22:00,1920,687,North,76,1040,563,Clothing,1233
23-04-2023 23:00,3376,2092,East,55,1067,546,Clothing,1284
24-04-2023 00:00,4009,1028,South,73,1399,462,Groceries,2981
24-04-2023 01:00,3510,933,East,82,711,315,Furniture,2577
24-04-2023 02:00,3993,2835,North,94,699,263,Clothing,1158
24-04-2023 03:00,1962,2441,North,65,1486,802,Furniture,-479
24-04-2023 04:00,4632,2304,East,99,677,686,Furniture,2328
24-04-2023 05:00,2827,802,South,61,1946,637,Clothing,2025
24-04-2023 06:00,4453,586,North,80,1430,610,Clothing,3867
24-04-2023 07:00,3883,937,East,86,1985,873,Clothing,2946
24-04-2023 08:00,2613,1545,West,62,543,893,Furniture,1068
24-04-2023 09:00,2640,1332,East,57,1954,320,Clothing,1308
24-04-2023 10:00,3216,1296,East,87,667,654,Clothing,1920
24-04-2023 11:00,1216,1059,South,52,786,733,Clothing,157
24-04-2023 12:00,1377,1261,East,69,1208,740,Clothing,116
24-04-2023 13:00,1118,2198,West,53,836,876,Groceries,-1080
24-04-2023 14:00,1189,1624,East,93,1085,382,Clothing,-435
24-04-2023 15:00,3814,1184,West,94,1694,170,Furniture,2630
24-04-2023 16:00,1369,1664,North,51,682,984,Furniture,-295
24-04-2023 17:00,2801,637,East,85,515,473,Electronics,2164
24-04-2023 18:00,3196,1077,South,72,1386,358,Groceries,2119
24-04-2023 19:00,4747,1209,East,94,1336,544,Groceries,3538
24-04-2023 20:00,1651,727,West,68,609,300,Electronics,924
24-04-2023 21:00,2882,2828,West,89,805,741,Furniture,54
24-04-2023 22:00,2511,1327,South,57,1479,479,Furniture,1184
24-04-2023 23:00,1769,930,West,65,505,941,Clothing,839
25-04-2023 00:00,3421,1563,East,92,1342,692,Electronics,1858
25-04-2023 01:00,1780,2209,West,67,1796,865,Furniture,-429
25-04-2023 02:00,2716,2186,East,85,860,514,Electronics,530
25-04-2023 03:00,3207,1734,East,73,1708,164,Electronics,1473
25-04-2023 04:00,3398,801,West,50,1155,477,Groceries,2597
25-04-2023 05:00,4983,1609,South,50,1623,757,Furniture,3374
25-04-2023 06:00,2311,1920,North,95,1613,745,Furniture,391
25-04-2023 07:00,4359,1032,South,85,1483,201,Clothing,3327
25-04-2023 08:00,3939,1268,North,60,1769,141,Furniture,2671
25-04-2023 09:00,2249,2438,South,67,1762,978,Groceries,-189
25-04-2023 10:00,1522,1904,East,65,1223,295,Furniture,-382
25-04-2023 11:00,1521,943,East,66,1604,459,Clothing,578
25-04-2023 12:00,1782,759,West,73,614,871,Furniture,1023
25-04-2023 13:00,3320,2038,North,83,775,198,Electronics,1282
25-04-2023 14:00,1935,1831,North,53,579,487,Groceries,104
25-04-2023 15:00,4473,569,West,84,678,164,Clothing,3904
25-04-2023 16:00,3230,1977,South,64,1832,396,Clothing,1253
25-04-2023 17:00,2688,1962,West,51,1060,526,Electronics,726
25-04-2023 18:00,1487,2348,South,80,1008,322,Groceries,-861
25-04-2023 19:00,2850,980,West,58,759,856,Furniture,1870
25-04-2023 20:00,1845,1667,North,59,791,794,Groceries,178
25-04-2023 21:00,3171,2571,North,74,1384,248,Groceries,600
25-04-2023 22:00,4032,1698,South,54,790,608,Groceries,2334
25-04-2023 23:00,4697,2872,North,63,1041,541,Groceries,1825
26-04-2023 00:00,3837,2392,North,91,1263,513,Groceries,1445
26-04-2023 01:00,3461,2194,North,97,1586,215,Groceries,1267
26-04-2023 02:00,3003,2383,North,87,1093,552,Electronics,620
26-04-2023 03:00,2748,1871,East,89,1928,419,Clothing,877
26-04-2023 04:00,4243,1297,West,51,1447,869,Electronics,2946
26-04-2023 05:00,4359,517,West,67,979,982,Furniture,3842
26-04-2023 06:00,4506,543,East,78,1848,550,Clothing,3963
26-04-2023 07:00,1685,654,North,69,880,995,Clothing,1031
26-04-2023 08:00,3160,1366,West,57,809,178,Furniture,1794
26-04-2023 09:00,3935,1242,West,86,1866,842,Clothing,2693
26-04-2023 10:00,4988,2351,West,98,1998,456,Furniture,2637
26-04-2023 11:00,3169,1925,South,97,1579,218,Groceries,1244
26-04-2023 12:00,2567,724,East,75,1346,685,Groceries,1843
26-04-2023 13:00,2245,716,South,86,924,620,Clothing,1529
26-04-2023 14:00,4702,530,South,98,1665,378,Clothing,4172
26-04-2023 15:00,1038,2392,East,53,1160,881,Groceries,-1354
26-04-2023 16:00,3544,1582,West,82,1899,665,Groceries,1962
26-04-2023 17:00,1779,2415,South,71,725,991,Furniture,-636
26-04-2023 18:00,2256,1397,West,55,1997,144,Clothing,859
26-04-2023 19:00,3990,944,South,82,524,324,Clothing,3046
26-04-2023 20:00,4601,1758,West,77,1888,627,Electronics,2843
26-04-2023 21:00,3196,1630,North,73,594,823,Groceries,1566
26-04-2023 22:00,4468,1714,North,53,1007,811,Groceries,2754
26-04-2023 23:00,4069,2515,North,51,1064,340,Clothing,1554
27-04-2023 00:00,3708,2436,East,62,1699,713,Electronics,1272
27-04-2023 01:00,4709,1237,North,95,1143,581,Furniture,3472
27-04-2023 02:00,2927,2202,South,98,1931,194,Furniture,725
27-04-2023 03:00,1301,1373,West,60,989,464,Groceries,-72
27-04-2023 04:00,4431,1065,West,84,958,284,Electronics,3366
27-04-2023 05:00,3285,2518,West,88,1936,235,Electronics,767
27-04-2023 06:00,1646,2385,West,59,1400,124,Furniture,-739
27-04-2023 07:00,1662,2623,South,92,837,417,Groceries,-961
27-04-2023 08:00,3283,1046,West,59,1462,432,Clothing,2237
27-04-2023 09:00,2759,2814,South,57,1854,661,Electronics,-55
27-04-2023 10:00,3250,816,South,54,1736,780,Clothing,2434
27-04-2023 11:00,1255,2359,West,72,844,901,Groceries,-1104
27-04-2023 12:00,1597,524,West,83,1075,199,Furniture,1073
27-04-2023 13:00,1661,659,West,96,1442,469,Electronics,1002
27-04-2023 14:00,1234,1637,South,81,845,692,Clothing,-403
27-04-2023 15:00,2368,1399,East,65,1771,111,Electronics,969
27-04-2023 16:00,3581,1689,South,53,824,819,Electronics,1892
27-04-2023 17:00,3907,1202,East,77,966,176,Electronics,2705
27-04-2023 18:00,4868,500,West,97,590,686,Groceries,4368
27-04-2023 19:00,4852,2422,South,93,793,781,Clothing,2430
27-04-2023 20:00,4537,2867,West,63,1023,922,Electronics,1670
27-04-2023 21:00,1769,1924,East,61,1349,447,Clothing,-155
27-04-2023 22:00,3588,881,East,70,758,542,Groceries,2707
27-04-2023 23:00,1212,2241,South,97,1610,790,Electronics,-1029
28-04-2023 00:00,1462,2326,South,65,1681,187,Electronics,-864
28-04-2023 01:00,3483,1773,South,93,685,564,Electronics,1710
28-04-2023 02:00,1282,2048,South,51,843,876,Clothing,-766
28-04-2023 03:00,4633,2078,North,72,1320,593,Clothing,2555
28-04-2023 04:00,4678,1397,North,78,1240,321,Electronics,3281
28-04-2023 05:00,2486,1216,West,95,1068,614,Clothing,1270
28-04-2023 06:00,2430,2854,East,92,1449,217,Clothing,-424
28-04-2023 07:00,1087,890,East,58,1008,235,Electronics,197
28-04-2023 08:00,2067,2199,West,56,515,286,Electronics,-132
28-04-2023 09:00,1460,2845,West,78,1024,641,Furniture,-1385
28-04-2023 10:00,3325,732,West,93,699,678,Furniture,2593
28-04-2023 11:00,4754,2426,North,66,1707,410,Electronics,2328
28-04-2023 12:00,3468,2818,West,58,808,478,Groceries,650
28-04-2023 13:00,2724,1819,East,55,1804,910,Electronics,905
28-04-2023 14:00,2376,1205,West,93,1681,511,Electronics,1171
28-04-2023 15:00,3743,733,South,69,1883,520,Electronics,3010
28-04-2023 16:00,1514,1891,East,59,758,316,Electronics,-377
28-04-2023 17:00,1702,1755,East,58,1680,769,Electronics,-53
28-04-2023 18:00,2653,2396,East,61,924,170,Electronics,257
28-04-2023 19:00,3066,1389,North,82,1278,929,Electronics,1677
28-04-2023 20:00,1022,1091,North,81,1544,209,Electronics,-69
28-04-2023 21:00,3460,1245,East,83,1138,384,Furniture,2215
28-04-2023 22:00,2053,2219,South,68,1870,982,Furniture,-166
28-04-2023 23:00,2830,927,East,82,1419,869,Furniture,1903
29-04-2023 00:00,3155,1231,North,97,1511,701,Groceries,1924
29-04-2023 01:00,4438,1299,South,65,849,972,Clothing,3139
29-04-2023 02:00,2304,2911,East,99,1460,668,Groceries,-607
29-04-2023 03:00,4199,701,North,99,1908,397,Groceries,3498
29-04-2023 04:00,4300,2693,South,72,937,598,Electronics,1607
29-04-2023 05:00,2134,1335,West,75,955,660,Furniture,799
29-04-2023 06:00,3183,634,West,94,1123,796,Electronics,2549
29-04-2023 07:00,1361,1787,East,93,1603,810,Electronics,-426
29-04-2023 08:00,4257,2611,West,90,1975,629,Furniture,1646
29-04-2023 09:00,4727,540,North,86,1142,297,Electronics,4187
29-04-2023 10:00,4655,1412,South,58,891,606,Clothing,3243
29-04-2023 11:00,3176,2229,East,79,1073,588,Clothing,947
29-04-2023 12:00,2899,1474,South,62,1882,843,Groceries,1425
29-04-2023 13:00,2284,1633,South,97,532,126,Furniture,651
29-04-2023 14:00,1514,2915,South,91,1659,217,Clothing,-1401
29-04-2023 15:00,1448,1959,North,65,1420,153,Groceries,-511
29-04-2023 16:00,2923,2540,East,95,909,603,Electronics,383
29-04-2023 17:00,4175,743,West,51,1522,251,Groceries,3432
29-04-2023 18:00,2506,665,South,80,1614,836,Groceries,1841
29-04-2023 19:00,2247,1549,South,92,912,578,Clothing,698
29-04-2023 20:00,2855,1997,South,68,798,261,Groceries,858
29-04-2023 21:00,1873,1227,North,60,572,761,Furniture,646
29-04-2023 22:00,4937,1615,West,63,760,315,Electronics,3322
29-04-2023 23:00,4562,982,South,96,1189,930,Furniture,3580
30-04-2023 00:00,3520,2947,North,74,1835,519,Electronics,573
30-04-2023 01:00,4081,1730,North,56,1458,447,Furniture,2351
30-04-2023 02:00,2428,2648,South,64,1231,439,Electronics,-220
30-04-2023 03:00,4967,1379,South,79,1184,928,Furniture,3588
30-04-2023 04:00,3349,1329,North,80,1688,949,Electronics,2020
30-04-2023 05:00,3278,2524,North,73,1339,653,Clothing,754
30-04-2023 06:00,2754,1258,South,74,834,451,Groceries,1496
30-04-2023 07:00,1922,662,North,57,1231,772,Groceries,1260
30-04-2023 08:00,4137,1696,North,79,1303,685,Groceries,2441
30-04-2023 09:00,3984,1807,South,85,1684,474,Groceries,2177
30-04-2023 10:00,3159,2928,South,99,889,636,Electronics,231
30-04-2023 11:00,2036,2495,East,63,1259,402,Furniture,-459
30-04-2023 12:00,2416,2434,West,78,1382,341,Furniture,-18
30-04-2023 13:00,3547,2056,South,76,1471,477,Clothing,1491
30-04-2023 14:00,3979,806,South,99,1594,784,Groceries,3173
30-04-2023 15:00,3645,1862,South,85,1440,488,Groceries,1783
30-04-2023 16:00,3281,2602,West,83,1615,386,Clothing,679
30-04-2023 17:00,3649,832,East,70,1402,258,Groceries,2817
30-04-2023 18:00,1313,2674,North,87,1884,453,Clothing,-1361
30-04-2023 19:00,3613,742,West,60,1844,829,Groceries,2871
30-04-2023 20:00,4083,2384,South,82,1768,554,Furniture,1699
30-04-2023 21:00,3256,1932,South,64,523,726,Clothing,1324
30-04-2023 22:00,2997,802,East,61,1056,340,Furniture,2195
30-04-2023 23:00,2037,734,East,73,1200,919,Groceries,1303
01-05-2023 00:00,2656,2686,East,99,902,311,Furniture,-30
01-05-2023 01:00,4489,694,North,86,1896,462,Furniture,3795
01-05-2023 02:00,4508,2050,West,60,1809,697,Electronics,2458
01-05-2023 03:00,4448,2292,West,68,940,232,Groceries,2156
01-05-2023 04:00,4091,1146,East,50,1381,879,Electronics,2945
01-05-2023 05:00,3634,2548,North,66,1875,608,Clothing,1086
01-05-2023 06:00,4983,1060,West,89,1425,376,Electronics,3923
01-05-2023 07:00,2778,1619,South,65,1742,364,Groceries,1159
01-05-2023 08:00,4806,1212,South,75,984,704,Electronics,3594
01-05-2023 09:00,2014,912,South,92,1966,702,Electronics,1102
01-05-2023 10:00,2093,1037,West,92,1741,756,Groceries,1056
01-05-2023 11:00,4895,2378,East,64,1590,459,Furniture,2517
01-05-2023 12:00,4282,2976,South,57,530,763,Clothing,1306
01-05-2023 13:00,2124,734,East,79,821,766,Electronics,1390
01-05-2023 14:00,1697,2896,North,63,1773,235,Groceries,-1199
01-05-2023 15:00,3179,2279,South,82,1065,864,Electronics,900
01-05-2023 16:00,4694,2393,North,91,509,527,Clothing,2301
01-05-2023 17:00,2404,2004,East,56,1177,929,Clothing,400
01-05-2023 18:00,2155,2362,West,67,1350,128,Clothing,-207
01-05-2023 19:00,2043,2943,East,61,1426,694,Electronics,-900
01-05-2023 20:00,2929,1874,South,51,784,429,Furniture,1055
01-05-2023 21:00,3583,915,South,99,652,133,Furniture,2668
01-05-2023 22:00,2013,2409,East,78,870,603,Furniture,-396
01-05-2023 23:00,1226,1415,South,70,800,927,Groceries,-189
02-05-2023 00:00,4225,580,South,56,645,203,Furniture,3645
02-05-2023 01:00,2828,2583,North,76,1575,593,Furniture,245
02-05-2023 02:00,4813,1590,West,61,1927,470,Clothing,3223
02-05-2023 03:00,2492,2190,East,69,1201,487,Groceries,302
02-05-2023 04:00,1821,1256,North,63,640,844,Clothing,565
02-05-2023 05:00,3023,967,South,59,1611,336,Electronics,2056
02-05-2023 06:00,1870,1665,North,90,1950,834,Electronics,205
02-05-2023 07:00,3452,2903,West,72,583,189,Clothing,549
02-05-2023 08:00,3249,1994,East,79,1766,432,Groceries,1255
02-05-2023 09:00,3085,2144,West,96,1629,476,Furniture,941
02-05-2023 10:00,3989,1519,West,80,1878,339,Furniture,2470
02-05-2023 11:00,2795,2114,North,59,520,829,Groceries,681
02-05-2023 12:00,1187,1401,North,68,1529,281,Furniture,-214
02-05-2023 13:00,2080,1172,West,68,1466,356,Furniture,908
02-05-2023 14:00,1940,938,South,93,1744,843,Clothing,1002
02-05-2023 15:00,4091,626,East,72,1610,288,Electronics,3465
02-05-2023 16:00,3320,2752,South,93,952,940,Groceries,568
02-05-2023 17:00,4190,2576,South,90,841,514,Groceries,1614
02-05-2023 18:00,3630,944,East,81,892,955,Furniture,2686
02-05-2023 19:00,3563,1465,North,69,1875,354,Furniture,2098
02-05-2023 20:00,4292,963,South,53,1769,144,Electronics,3329
02-05-2023 21:00,1525,2698,North,82,1502,927,Groceries,-1173
02-05-2023 22:00,4586,2787,East,97,1636,697,Clothing,1799
02-05-2023 23:00,4799,2813,South,50,1470,300,Electronics,1986
03-05-2023 00:00,4812,1412,North,62,657,458,Clothing,3400
03-05-2023 01:00,1335,996,North,52,1310,442,Electronics,339
03-05-2023 02:00,3745,1963,South,61,1760,311,Clothing,1782
03-05-2023 03:00,2078,2271,East,78,1198,730,Clothing,-193
03-05-2023 04:00,3547,657,West,80,1766,397,Clothing,2890
03-05-2023 05:00,3947,671,North,90,665,254,Groceries,3276
03-05-2023 06:00,4959,993,East,85,533,797,Furniture,3966
03-05-2023 07:00,3813,1469,South,51,754,296,Groceries,2344
03-05-2023 08:00,3583,1834,North,71,801,948,Clothing,1749
03-05-2023 09:00,1161,1926,North,71,719,581,Furniture,-765
03-05-2023 10:00,4741,2192,North,90,1555,812,Clothing,2549
03-05-2023 11:00,1593,2293,East,80,1434,877,Electronics,-700
03-05-2023 12:00,2938,1158,North,94,1008,478,Furniture,1780
03-05-2023 13:00,3206,1165,North,63,1756,847,Groceries,2041
03-05-2023 14:00,4259,866,South,78,1452,805,Clothing,3393
03-05-2023 15:00,1059,1049,North,84,714,466,Furniture,10
03-05-2023 16:00,3962,1142,East,99,1765,636,Groceries,2820
03-05-2023 17:00,4888,2393,South,58,744,870,Electronics,2495
03-05-2023 18:00,4390,754,West,96,519,170,Clothing,3636
03-05-2023 19:00,2901,707,South,81,709,127,Groceries,2194
03-05-2023 20:00,3258,2997,North,76,925,492,Furniture,261
03-05-2023 21:00,1405,594,West,59,1499,622,Electronics,811
03-05-2023 22:00,1663,2383,South,74,1480,448,Clothing,-720
03-05-2023 23:00,2132,977,North,98,571,217,Groceries,1155
04-05-2023 00:00,2099,1261,South,94,677,479,Electronics,838
04-05-2023 01:00,1541,689,East,82,798,307,Electronics,852
04-05-2023 02:00,2337,2007,North,60,765,522,Groceries,330
04-05-2023 03:00,1997,2256,East,86,1019,192,Clothing,-259
04-05-2023 04:00,2140,2059,North,58,774,240,Groceries,81
04-05-2023 05:00,3974,1255,East,56,1447,454,Electronics,2719
04-05-2023 06:00,1867,1946,West,56,552,622,Electronics,-79
04-05-2023 07:00,4775,1335,East,83,1311,902,Furniture,3440
04-05-2023 08:00,3066,2163,South,68,1923,850,Clothing,903
04-05-2023 09:00,1431,2128,North,69,1937,875,Groceries,-697
04-05-2023 10:00,4756,2335,South,99,988,874,Clothing,2421
04-05-2023 11:00,1739,632,East,91,1001,168,Clothing,1107
04-05-2023 12:00,2373,554,North,74,806,681,Electronics,1819
04-05-2023 13:00,1182,1009,East,54,916,796,Furniture,173
04-05-2023 14:00,3160,1169,West,97,1008,982,Groceries,1991
04-05-2023 15:00,2206,2957,West,78,1420,223,Groceries,-751
04-05-2023 16:00,3528,2189,West,76,1137,518,Furniture,1339
04-05-2023 17:00,2169,1816,East,74,1165,833,Furniture,353
04-05-2023 18:00,1830,1233,East,86,505,622,Electronics,597
04-05-2023 19:00,2651,2193,West,64,921,777,Electronics,458
04-05-2023 20:00,2136,758,East,97,1974,702,Groceries,1378
04-05-2023 21:00,3810,1645,South,53,1950,859,Furniture,2165
04-05-2023 22:00,1475,798,East,63,889,440,Clothing,677
04-05-2023 23:00,3810,1060,South,98,833,404,Clothing,2750
05-05-2023 00:00,2326,2412,West,66,1971,902,Furniture,-86
05-05-2023 01:00,1970,2364,East,70,837,256,Groceries,-394
05-05-2023 02:00,4896,796,West,65,1347,187,Clothing,4100
05-05-2023 03:00,2019,2909,North,75,1611,327,Clothing,-890
05-05-2023 04:00,2141,1961,East,58,768,464,Furniture,180
05-05-2023 05:00,2836,2674,East,51,564,745,Electronics,162
05-05-2023 06:00,1160,696,West,92,1177,365,Clothing,464
05-05-2023 07:00,3448,2768,West,64,1587,183,Electronics,680
05-05-2023 08:00,1197,1494,West,84,1793,311,Clothing,-297
05-05-2023 09:00,2283,2638,North,73,1156,317,Groceries,-355
05-05-2023 10:00,1659,2958,North,97,1900,952,Electronics,-1299
05-05-2023 11:00,2775,507,West,87,1280,848,Groceries,2268
05-05-2023 12:00,2070,819,East,63,828,250,Electronics,1251
05-05-2023 13:00,3010,1917,East,86,1017,785,Furniture,1093
05-05-2023 14:00,1398,2816,West,86,1361,239,Furniture,-1418
05-05-2023 15:00,2733,2198,South,55,920,154,Clothing,535
05-05-2023 16:00,2582,2608,North,67,1836,240,Groceries,-26
05-05-2023 17:00,3125,1961,North,71,808,173,Electronics,1164
05-05-2023 18:00,3171,1787,South,67,1313,234,Groceries,1384
05-05-2023 19:00,1074,1618,West,51,1345,928,Groceries,-544
05-05-2023 20:00,4942,1052,East,81,1461,741,Clothing,3890
05-05-2023 21:00,3184,1160,East,66,1712,843,Furniture,2024
05-05-2023 22:00,1601,1215,North,50,1220,125,Electronics,386
05-05-2023 23:00,4471,2741,South,58,1565,587,Clothing,1730
06-05-2023 00:00,1836,1958,East,62,1089,534,Groceries,-122
06-05-2023 01:00,2528,1354,North,85,819,680,Furniture,1174
06-05-2023 02:00,1499,2759,East,86,1510,161,Furniture,-1260
06-05-2023 03:00,2596,1164,East,79,944,299,Electronics,1432
06-05-2023 04:00,1137,2397,East,80,1897,589,Furniture,-1260
06-05-2023 05:00,3097,2174,North,72,785,592,Groceries,923
06-05-2023 06:00,2794,2768,South,99,670,778,Furniture,26
06-05-2023 07:00,1972,772,West,77,762,567,Groceries,1200
06-05-2023 08:00,2642,1677,South,59,1441,215,Electronics,965
06-05-2023 09:00,4696,1772,East,74,641,470,Groceries,2924
06-05-2023 10:00,2885,778,South,85,1671,750,Furniture,2107
06-05-2023 11:00,3301,1315,East,75,1963,331,Furniture,1986
06-05-2023 12:00,4701,775,North,75,1127,547,Electronics,3926
06-05-2023 13:00,3028,1504,North,94,1092,313,Electronics,1524
06-05-2023 14:00,3757,1422,North,62,915,307,Furniture,2335
06-05-2023 15:00,4920,1141,East,66,524,201,Electronics,3779
06-05-2023 16:00,2900,1004,South,89,1126,909,Groceries,1896
06-05-2023 17:00,3610,1271,West,53,593,109,Clothing,2339
06-05-2023 18:00,3804,1764,West,72,804,572,Groceries,2040
06-05-2023 19:00,4986,1759,North,84,684,222,Groceries,3227
06-05-2023 20:00,2449,1513,West,60,782,886,Electronics,936
06-05-2023 21:00,1546,627,East,61,1678,103,Clothing,919
06-05-2023 22:00,4373,1723,South,58,1185,566,Furniture,2650
06-05-2023 23:00,1921,2025,West,64,1362,358,Electronics,-104
07-05-2023 00:00,1580,2173,West,94,1184,820,Groceries,-593
07-05-2023 01:00,2372,991,South,86,1165,877,Clothing,1381
07-05-2023 02:00,4903,1757,West,54,1537,873,Electronics,3146
07-05-2023 03:00,2956,2166,South,68,1389,386,Groceries,790
07-05-2023 04:00,3003,915,East,60,1315,130,Groceries,2088
07-05-2023 05:00,3096,2695,East,58,840,787,Furniture,401
07-05-2023 06:00,3964,1469,East,84,1103,620,Furniture,2495
07-05-2023 07:00,4145,2576,North,99,1233,815,Clothing,1569
07-05-2023 08:00,1703,1884,East,76,1996,719,Groceries,-181
07-05-2023 09:00,3308,807,West,62,1318,223,Groceries,2501
07-05-2023 10:00,3403,2709,North,61,1406,849,Furniture,694
07-05-2023 11:00,4653,560,North,58,1631,229,Groceries,4093
07-05-2023 12:00,2625,2672,North,91,1854,845,Furniture,-47
07-05-2023 13:00,4331,1979,East,77,1039,615,Groceries,2352
07-05-2023 14:00,1637,2430,North,62,938,579,Furniture,-793
07-05-2023 15:00,3790,2790,East,69,1487,831,Furniture,1000
07-05-2023 16:00,4366,2013,East,62,1165,873,Clothing,2353
07-05-2023 17:00,2009,972,North,76,883,641,Groceries,1037
07-05-2023 18:00,3978,1458,North,75,1081,928,Groceries,2520
07-05-2023 19:00,1640,1032,West,78,659,176,Furniture,608
07-05-2023 20:00,3839,993,North,78,931,282,Groceries,2846
07-05-2023 21:00,4384,581,East,71,1919,465,Furniture,3803
07-05-2023 22:00,3659,1378,West,58,1114,391,Clothing,2281
07-05-2023 23:00,2861,2045,West,73,987,813,Clothing,816
08-05-2023 00:00,3856,511,East,91,1712,488,Furniture,3345
08-05-2023 01:00,2205,1786,North,68,1941,256,Electronics,419
08-05-2023 02:00,1685,948,North,87,842,199,Clothing,737
08-05-2023 03:00,2851,1261,South,80,1884,733,Groceries,1590
08-05-2023 04:00,4435,525,North,88,608,926,Furniture,3910
08-05-2023 05:00,1187,2306,South,64,1348,209,Furniture,-1119
08-05-2023 06:00,4640,2068,West,81,800,778,Clothing,2572
08-05-2023 07:00,4614,561,West,95,1891,741,Furniture,4053
08-05-2023 08:00,2619,728,West,97,1778,369,Clothing,1891
08-05-2023 09:00,2687,2338,South,95,1839,237,Furniture,349
08-05-2023 10:00,1984,1106,East,78,1204,787,Clothing,878
08-05-2023 11:00,1547,1558,East,83,1594,163,Groceries,-11
08-05-2023 12:00,3772,2228,West,58,768,742,Electronics,1544
08-05-2023 13:00,3973,1979,South,84,1732,606,Electronics,1994
08-05-2023 14:00,2431,2025,South,55,977,939,Electronics,406
08-05-2023 15:00,1875,1260,West,86,675,799,Electronics,615
08-05-2023 16:00,1617,1094,North,63,738,888,Clothing,523
08-05-2023 17:00,3461,2092,West,96,1392,449,Furniture,1369
08-05-2023 18:00,2365,1555,South,99,1109,246,Electronics,810
08-05-2023 19:00,2243,2354,North,98,1358,434,Furniture,-111
08-05-2023 20:00,1902,2548,East,58,1965,631,Clothing,-646
08-05-2023 21:00,1162,1958,North,68,991,925,Clothing,-796
08-05-2023 22:00,2974,2361,East,72,598,653,Electronics,613
08-05-2023 23:00,4291,1659,South,90,828,961,Groceries,2632
09-05-2023 00:00,1269,1719,West,77,1849,506,Electronics,-450
09-05-2023 01:00,1631,632,West,65,944,443,Furniture,999
09-05-2023 02:00,1905,585,West,75,1497,751,Electronics,1320
09-05-2023 03:00,4919,1999,West,87,794,620,Clothing,2920
09-05-2023 04:00,4471,2330,West,89,941,690,Clothing,2141
09-05-2023 05:00,4253,1703,South,74,1294,949,Furniture,2550
09-05-2023 06:00,3014,674,South,84,1390,759,Furniture,2340
09-05-2023 07:00,2641,2475,West,54,530,804,Furniture,166
09-05-2023 08:00,4800,1077,North,56,1654,870,Electronics,3723
09-05-2023 09:00,1204,2298,West,72,937,235,Electronics,-1094
09-05-2023 10:00,1581,2596,East,74,1849,138,Groceries,-1015
09-05-2023 11:00,2579,644,East,50,1790,419,Furniture,1935
09-05-2023 12:00,1840,1261,East,71,785,386,Groceries,579
09-05-2023 13:00,2836,1877,East,53,790,978,Groceries,959
09-05-2023 14:00,2251,2325,West,77,867,562,Clothing,-74
09-05-2023 15:00,2719,1428,East,97,985,990,Groceries,1291
09-05-2023 16:00,2642,1293,North,63,1054,761,Clothing,1349
09-05-2023 17:00,3643,2101,West,82,667,451,Furniture,1542
09-05-2023 18:00,4921,2160,East,53,1994,104,Clothing,2761
09-05-2023 19:00,3297,818,West,91,1693,335,Furniture,2479
09-05-2023 20:00,1874,1610,West,60,1270,335,Electronics,264
09-05-2023 21:00,2464,2076,West,88,1869,925,Groceries,388
09-05-2023 22:00,4604,1197,South,81,577,600,Furniture,3407
09-05-2023 23:00,3243,1346,East,53,1350,204,Electronics,1897
10-05-2023 00:00,1689,2301,South,50,1608,306,Electronics,-612
10-05-2023 01:00,3010,1282,North,75,1391,338,Furniture,1728
10-05-2023 02:00,4590,2589,North,82,1160,930,Clothing,2001
10-05-2023 03:00,4141,1616,South,66,1724,928,Furniture,2525
10-05-2023 04:00,3686,2250,East,76,1088,151,Groceries,1436
10-05-2023 05:00,2422,2149,West,91,1884,207,Electronics,273
10-05-2023 06:00,3001,791,North,54,1261,456,Clothing,2210
10-05-2023 07:00,1671,1468,North,56,1064,132,Furniture,203
10-05-2023 08:00,4831,1987,North,74,1311,121,Furniture,2844
10-05-2023 09:00,4274,2342,East,57,801,406,Electronics,1932
10-05-2023 10:00,2171,596,South,83,792,110,Furniture,1575
10-05-2023 11:00,2495,1618,South,90,793,738,Groceries,877
10-05-2023 12:00,4726,573,East,53,608,541,Clothing,4153
10-05-2023 13:00,1943,1859,North,61,864,661,Groceries,84
10-05-2023 14:00,3246,1591,East,80,1099,297,Electronics,1655
10-05-2023 15:00,4988,1257,East,60,1177,628,Clothing,3731
10-05-2023 16:00,2449,2441,South,86,1790,143,Electronics,8
10-05-2023 17:00,4737,707,East,93,592,284,Electronics,4030
10-05-2023 18:00,3539,1744,East,85,1587,488,Groceries,1795
10-05-2023 19:00,4959,1785,North,94,927,650,Clothing,3174
10-05-2023 20:00,1895,909,West,71,1137,606,Electronics,986
10-05-2023 21:00,3189,2878,North,50,867,541,Groceries,311
10-05-2023 22:00,2336,2891,South,99,604,595,Groceries,-555
10-05-2023 23:00,1164,1270,West,53,708,604,Clothing,-106
11-05-2023 00:00,3361,2343,North,85,1511,236,Furniture,1018
11-05-2023 01:00,3068,573,East,57,973,378,Furniture,2495
11-05-2023 02:00,2105,2160,East,74,1584,263,Electronics,-55
11-05-2023 03:00,4652,753,West,77,1869,642,Furniture,3899
11-05-2023 04:00,4202,1319,West,87,511,951,Clothing,2883
11-05-2023 05:00,4670,1485,East,85,965,122,Furniture,3185
11-05-2023 06:00,2753,831,South,85,1148,810,Clothing,1922
11-05-2023 07:00,4031,1921,North,92,1718,606,Electronics,2110
11-05-2023 08:00,3352,1335,East,90,1597,785,Furniture,2017
11-05-2023 09:00,2938,2191,North,95,1374,609,Clothing,747
11-05-2023 10:00,1370,954,North,53,885,669,Clothing,416
11-05-2023 11:00,2880,2429,North,62,1659,807,Clothing,451
11-05-2023 12:00,1852,1638,North,87,1383,699,Groceries,214
11-05-2023 13:00,1383,812,South,94,1054,543,Electronics,571
11-05-2023 14:00,2931,1517,South,74,1959,241,Clothing,1414
11-05-2023 15:00,3492,727,South,52,1562,380,Groceries,2765
11-05-2023 16:00,1424,1357,East,81,1153,306,Groceries,67
11-05-2023 17:00,3208,1768,East,88,1843,783,Clothing,1440
11-05-2023 18:00,4249,1517,East,50,1364,401,Electronics,2732
11-05-2023 19:00,1628,1449,South,60,1488,496,Furniture,179
11-05-2023 20:00,4779,926,North,51,852,417,Groceries,3853
11-05-2023 21:00,1894,2589,South,54,1013,886,Clothing,-695
11-05-2023 22:00,3537,964,East,71,1939,979,Electronics,2573
11-05-2023 23:00,4064,2145,West,95,1303,957,Electronics,1919
12-05-2023 00:00,3374,777,East,62,1893,147,Clothing,2597
12-05-2023 01:00,1597,518,North,97,842,772,Groceries,1079
12-05-2023 02:00,4062,565,South,72,1848,776,Furniture,3497
12-05-2023 03:00,3336,666,West,96,1890,489,Electronics,2670
12-05-2023 04:00,1592,2108,West,80,835,478,Furniture,-516
12-05-2023 05:00,2687,902,North,84,1819,316,Electronics,1785
12-05-2023 06:00,4644,908,South,87,523,728,Electronics,3736
12-05-2023 07:00,1572,2659,West,90,1384,948,Electronics,-1087
12-05-2023 08:00,4425,1096,East,84,1965,350,Groceries,3329
12-05-2023 09:00,3075,1562,North,94,603,967,Groceries,1513
12-05-2023 10:00,4001,2652,West,62,1935,533,Clothing,1349
12-05-2023 11:00,3090,823,North,56,1073,855,Furniture,2267
12-05-2023 12:00,2704,2482,South,54,1274,858,Furniture,222
12-05-2023 13:00,3470,1937,South,78,1817,684,Clothing,1533
12-05-2023 14:00,4669,928,South,57,1386,383,Groceries,3741
12-05-2023 15:00,1176,1584,East,57,742,582,Furniture,-408
12-05-2023 16:00,1528,2135,West,56,841,806,Clothing,-607
12-05-2023 17:00,2633,1877,South,68,1132,366,Electronics,756
12-05-2023 18:00,1965,892,East,88,1364,698,Furniture,1073
12-05-2023 19:00,2517,2751,South,72,672,345,Groceries,-234
12-05-2023 20:00,1197,2805,South,85,1939,257,Furniture,-1608
12-05-2023 21:00,3657,2040,West,91,602,456,Electronics,1617
12-05-2023 22:00,4648,945,East,81,659,647,Groceries,3703
12-05-2023 23:00,3889,1703,South,94,1780,335,Groceries,2186
13-05-2023 00:00,1852,1523,East,53,1213,859,Clothing,329
13-05-2023 01:00,4588,841,East,79,1056,559,Groceries,3747
13-05-2023 02:00,2537,632,South,91,1075,199,Clothing,1905
13-05-2023 03:00,3069,2990,South,88,695,838,Groceries,79
13-05-2023 04:00,4183,2359,North,54,1488,218,Electronics,1824
13-05-2023 05:00,2080,2800,West,52,1914,453,Electronics,-720
13-05-2023 06:00,4137,764,South,71,1433,807,Electronics,3373
13-05-2023 07:00,3889,592,North,77,569,187,Electronics,3297
13-05-2023 08:00,1097,2185,West,71,1342,135,Electronics,-1088
13-05-2023 09:00,4215,1934,South,71,746,413,Furniture,2281
13-05-2023 10:00,2903,2685,East,83,828,639,Electronics,218
13-05-2023 11:00,1434,1731,West,78,657,650,Groceries,-297
13-05-2023 12:00,1636,1501,East,92,1417,421,Clothing,135
13-05-2023 13:00,4750,2160,North,91,1197,526,Furniture,2590
13-05-2023 14:00,4157,2096,South,62,1242,616,Groceries,2061
13-05-2023 15:00,1587,2854,North,56,1084,752,Electronics,-1267
13-05-2023 16:00,1343,765,South,59,554,839,Electronics,578
13-05-2023 17:00,2317,1145,South,77,985,108,Groceries,1172
13-05-2023 18:00,2979,2865,East,53,1766,458,Furniture,114
13-05-2023 19:00,1570,1636,North,81,1876,577,Clothing,-66
13-05-2023 20:00,4721,1901,East,71,909,156,Clothing,2820
13-05-2023 21:00,1610,953,East,69,1459,382,Clothing,657
13-05-2023 22:00,2727,2738,East,97,1404,544,Clothing,-11
13-05-2023 23:00,3290,2414,North,69,1226,560,Electronics,876
14-05-2023 00:00,2854,1963,South,55,1538,589,Furniture,891
14-05-2023 01:00,3608,1710,South,58,646,458,Electronics,1898
14-05-2023 02:00,1959,1330,North,77,1548,789,Furniture,629
14-05-2023 03:00,3079,1890,South,62,832,693,Clothing,1189
14-05-2023 04:00,3438,1612,North,80,1697,696,Groceries,1826
14-05-2023 05:00,3324,2734,North,88,789,164,Groceries,590
14-05-2023 06:00,1531,2469,South,99,1069,528,Electronics,-938
14-05-2023 07:00,2177,2679,West,63,1290,954,Groceries,-502
14-05-2023 08:00,3430,1371,East,71,1668,901,Electronics,2059
14-05-2023 09:00,2091,1134,North,86,1408,967,Electronics,957
14-05-2023 10:00,2901,1899,North,94,1645,556,Furniture,1002
14-05-2023 11:00,1883,1190,West,73,526,235,Clothing,693
14-05-2023 12:00,3261,2365,North,57,1589,861,Clothing,896
14-05-2023 13:00,2678,1557,North,64,1624,705,Clothing,1121
14-05-2023 14:00,3423,2455,South,90,1425,147,Clothing,968
14-05-2023 15:00,3791,1081,South,55,887,711,Furniture,2710
14-05-2023 16:00,3260,2718,West,72,1617,949,Clothing,542
14-05-2023 17:00,3126,1889,North,74,1590,293,Clothing,1237
14-05-2023 18:00,2749,1283,East,80,749,216,Groceries,1466
14-05-2023 19:00,3675,680,South,95,641,878,Clothing,2995
14-05-2023 20:00,3651,518,East,78,766,919,Clothing,3133
14-05-2023 21:00,1781,1749,East,72,714,263,Electronics,32
14-05-2023 22:00,4994,2116,West,59,988,578,Electronics,2878
14-05-2023 23:00,4452,2722,West,58,995,386,Clothing,1730
15-05-2023 00:00,4048,1745,North,98,979,635,Electronics,2303
15-05-2023 01:00,3727,2138,West,62,1142,593,Groceries,1589
15-05-2023 02:00,3105,553,South,81,500,504,Groceries,2552
15-05-2023 03:00,4867,1926,North,98,1532,195,Groceries,2941
15-05-2023 04:00,4097,2896,North,94,1340,596,Furniture,1201
15-05-2023 05:00,1880,942,East,90,879,353,Groceries,938
15-05-2023 06:00,1446,1079,East,50,1343,513,Clothing,367
15-05-2023 07:00,3113,781,East,50,1667,732,Groceries,2332
15-05-2023 08:00,4992,2907,North,86,801,683,Groceries,2085
15-05-2023 09:00,2783,1322,West,89,1149,964,Groceries,1461
15-05-2023 10:00,2277,2169,West,67,1940,470,Groceries,108
15-05-2023 11:00,4970,1140,West,85,1308,675,Electronics,3830
15-05-2023 12:00,2991,1531,North,80,1702,342,Groceries,1460
15-05-2023 13:00,2067,2516,North,50,1801,738,Groceries,-449
15-05-2023 14:00,4168,1062,North,96,1667,472,Electronics,3106
15-05-2023 15:00,2577,840,North,85,838,138,Electronics,1737
15-05-2023 16:00,2011,971,North,58,1982,996,Furniture,1040
15-05-2023 17:00,3274,2210,West,71,1854,452,Clothing,1064
15-05-2023 18:00,1773,2796,North,77,1793,525,Furniture,-1023
15-05-2023 19:00,3726,734,West,75,1498,176,Electronics,2992
15-05-2023 20:00,4507,1606,North,59,1710,609,Electronics,2901
15-05-2023 21:00,2814,1616,West,96,1165,616,Electronics,1198
15-05-2023 22:00,3648,2408,South,52,1695,239,Furniture,1240
15-05-2023 23:00,3426,1917,South,51,903,351,Groceries,1509
16-05-2023 00:00,2201,1323,West,86,1991,768,Clothing,878
16-05-2023 01:00,2450,1791,South,80,746,870,Clothing,659
16-05-2023 02:00,4986,1131,South,82,1058,416,Groceries,3855
16-05-2023 03:00,3756,1028,West,81,1277,519,Clothing,2728
16-05-2023 04:00,1306,2480,North,92,610,978,Groceries,-1174
16-05-2023 05:00,1778,2669,North,61,1487,848,Furniture,-891
16-05-2023 06:00,3551,2557,West,52,1312,174,Electronics,994
16-05-2023 07:00,3315,1839,East,97,1826,997,Groceries,1476
16-05-2023 08:00,4657,1796,East,75,1429,128,Groceries,2861
16-05-2023 09:00,1007,1829,South,63,1385,140,Electronics,-822
16-05-2023 10:00,4991,1733,East,61,1408,640,Electronics,3258
16-05-2023 11:00,3555,2481,South,75,1996,591,Clothing,1074
16-05-2023 12:00,1475,2253,North,65,1290,199,Groceries,-778
16-05-2023 13:00,2320,2448,West,57,791,419,Electronics,-128
16-05-2023 14:00,3211,2627,North,98,1775,669,Clothing,584
16-05-2023 15:00,1484,1401,West,98,674,822,Furniture,83
16-05-2023 16:00,4668,1390,East,77,608,749,Groceries,3278
16-05-2023 17:00,4143,2070,North,56,1461,622,Furniture,2073
16-05-2023 18:00,3614,2324,North,64,1863,944,Electronics,1290
16-05-2023 19:00,1904,2565,South,90,1347,975,Electronics,-661
16-05-2023 20:00,1558,1688,West,85,1537,288,Groceries,-130
16-05-2023 21:00,4982,2048,East,57,1192,549,Furniture,2934
16-05-2023 22:00,2967,701,North,59,1845,193,Electronics,2266
16-05-2023 23:00,3285,1240,West,64,1463,953,Groceries,2045
17-05-2023 00:00,2127,1869,East,67,542,280,Groceries,258
17-05-2023 01:00,2233,1889,North,95,960,420,Groceries,344
17-05-2023 02:00,3601,2500,West,86,1625,382,Electronics,1101
17-05-2023 03:00,3875,1971,South,90,1204,490,Electronics,1904
17-05-2023 04:00,1467,2036,North,94,1532,420,Groceries,-569
17-05-2023 05:00,4525,818,West,92,648,669,Clothing,3707
17-05-2023 06:00,4339,2764,East,93,837,124,Groceries,1575
17-05-2023 07:00,3433,1557,East,84,1502,915,Groceries,1876
17-05-2023 08:00,3822,2394,South,51,723,359,Groceries,1428
17-05-2023 09:00,1847,2813,North,71,1633,596,Clothing,-966
17-05-2023 10:00,3434,1223,South,64,853,312,Furniture,2211
17-05-2023 11:00,3924,2200,West,86,1607,214,Electronics,1724
17-05-2023 12:00,1258,912,East,88,1054,551,Electronics,346
17-05-2023 13:00,1282,1775,South,85,565,799,Furniture,-493
17-05-2023 14:00,2649,900,North,54,1911,871,Groceries,1749
17-05-2023 15:00,2898,2339,West,97,1120,747,Groceries,559
17-05-2023 16:00,1039,1223,North,64,1658,589,Electronics,-184
17-05-2023 17:00,3533,2829,South,76,1609,701,Groceries,704
17-05-2023 18:00,3976,1635,East,65,583,832,Furniture,2341
17-05-2023 19:00,3267,1250,East,85,726,627,Electronics,2017
17-05-2023 20:00,4200,767,South,87,1783,758,Clothing,3433
17-05-2023 21:00,2014,2845,North,67,1391,484,Groceries,-831
17-05-2023 22:00,4071,1840,North,84,1512,712,Furniture,2231
17-05-2023 23:00,4591,1069,North,74,519,517,Electronics,3522
18-05-2023 00:00,1612,2473,North,71,1558,318,Electronics,-861
18-05-2023 01:00,3975,1045,East,80,1254,979,Clothing,2930
18-05-2023 02:00,2915,864,North,86,1966,656,Groceries,2051
18-05-2023 03:00,1687,1046,South,83,1440,162,Clothing,641
18-05-2023 04:00,4690,770,South,72,769,449,Furniture,3920
18-05-2023 05:00,1612,1238,South,65,905,489,Electronics,374
18-05-2023 06:00,3307,1757,South,55,803,903,Electronics,1550
18-05-2023 07:00,4037,558,North,64,1808,476,Clothing,3479
18-05-2023 08:00,4013,1774,East,67,1508,970,Clothing,2239
18-05-2023 09:00,3413,2370,West,87,1309,165,Clothing,1043
18-05-2023 10:00,2781,585,North,62,1552,218,Groceries,2196
18-05-2023 11:00,2810,1262,West,73,890,845,Electronics,1548
18-05-2023 12:00,3591,889,East,62,1939,107,Groceries,2702
18-05-2023 13:00,3696,1703,North,50,1408,806,Furniture,1993
18-05-2023 14:00,2547,1218,West,97,641,838,Groceries,1329
18-05-2023 15:00,2930,648,East,85,1145,126,Clothing,2282
18-05-2023 16:00,3861,1082,West,98,1308,389,Furniture,2779
18-05-2023 17:00,4958,620,South,67,1447,127,Furniture,4338
18-05-2023 18:00,4087,2803,South,97,1864,258,Groceries,1284
18-05-2023 19:00,2152,1265,East,82,744,244,Groceries,887
18-05-2023 20:00,1574,1299,East,87,1265,566,Clothing,275
18-05-2023 21:00,4180,2606,West,92,1375,845,Clothing,1574
18-05-2023 22:00,2910,1521,East,55,1411,207,Furniture,1389
18-05-2023 23:00,2012,1969,South,66,1528,990,Clothing,43
19-05-2023 00:00,4604,2935,South,53,1419,538,Electronics,1669
19-05-2023 01:00,1669,1609,North,63,1438,302,Electronics,60
19-05-2023 02:00,1268,1750,West,79,948,876,Furniture,-482
19-05-2023 03:00,4233,2149,East,95,765,924,Groceries,2084
19-05-2023 04:00,2283,2315,East,69,1762,400,Groceries,-32
19-05-2023 05:00,1923,1845,East,57,749,537,Electronics,78
19-05-2023 06:00,2125,1841,West,51,1454,110,Groceries,284
19-05-2023 07:00,2529,2946,South,86,1814,936,Clothing,-417
19-05-2023 08:00,2758,2232,East,53,1042,706,Electronics,526
19-05-2023 09:00,2594,1398,East,59,1131,741,Furniture,1196
19-05-2023 10:00,1246,2840,South,69,1602,202,Groceries,-1594
19-05-2023 11:00,4711,984,East,84,1406,884,Furniture,3727
19-05-2023 12:00,4866,1302,North,97,1020,585,Furniture,3564
19-05-2023 13:00,4908,2215,South,59,1973,209,Groceries,2693
19-05-2023 14:00,2560,2415,South,77,1383,903,Groceries,145
19-05-2023 15:00,3178,2257,South,64,1233,742,Electronics,921
19-05-2023 16:00,3400,2309,North,85,643,802,Electronics,1091
19-05-2023 17:00,3243,2791,South,50,1643,910,Furniture,452
19-05-2023 18:00,4864,1943,West,71,1443,192,Furniture,2921
19-05-2023 19:00,2939,2452,West,76,1064,900,Electronics,487
19-05-2023 20:00,1929,2820,West,78,1699,817,Furniture,-891
19-05-2023 21:00,4737,2170,South,64,569,969,Clothing,2567
19-05-2023 22:00,4453,2348,South,59,1132,640,Groceries,2105
19-05-2023 23:00,4069,1019,South,69,1388,798,Groceries,3050
20-05-2023 00:00,3692,1651,North,71,1726,948,Clothing,2041
20-05-2023 01:00,1226,1896,West,99,1300,606,Electronics,-670
20-05-2023 02:00,3748,2706,East,97,679,276,Electronics,1042
20-05-2023 03:00,4547,1151,East,58,1092,538,Furniture,3396
20-05-2023 04:00,4548,2723,South,81,1066,942,Furniture,1825
20-05-2023 05:00,1264,2450,North,66,1190,767,Electronics,-1186
20-05-2023 06:00,2395,710,South,91,1633,857,Furniture,1685
20-05-2023 07:00,4557,2994,East,68,1947,810,Clothing,1563
20-05-2023 08:00,2457,1085,West,89,1164,610,Groceries,1372
20-05-2023 09:00,1645,666,East,76,905,208,Clothing,979
20-05-2023 10:00,3258,1756,West,86,1485,971,Groceries,1502
20-05-2023 11:00,4643,1705,West,83,1136,171,Groceries,2938
20-05-2023 12:00,4448,2238,North,96,1614,588,Furniture,2210
20-05-2023 13:00,2418,1552,East,98,1817,832,Furniture,866
20-05-2023 14:00,2473,1213,South,59,1916,380,Groceries,1260
20-05-2023 15:00,3990,1187,North,79,1560,988,Furniture,2803
20-05-2023 16:00,2387,829,West,70,1016,313,Clothing,1558
20-05-2023 17:00,2899,2246,East,70,1349,556,Electronics,653
20-05-2023 18:00,3504,1707,South,83,1407,686,Furniture,1797
20-05-2023 19:00,3772,2642,North,58,815,517,Furniture,1130
20-05-2023 20:00,4799,1284,South,83,1695,853,Furniture,3515
20-05-2023 21:00,2249,2900,East,99,1929,609,Electronics,-651
20-05-2023 22:00,1981,1440,South,61,1785,761,Clothing,541
20-05-2023 23:00,2154,1788,North,96,526,422,Groceries,366
21-05-2023 00:00,1587,2179,South,70,554,277,Clothing,-592
21-05-2023 01:00,1475,1125,East,69,748,787,Furniture,350
21-05-2023 02:00,2821,638,North,55,772,203,Electronics,2183
21-05-2023 03:00,1985,1261,West,99,1782,218,Clothing,724
21-05-2023 04:00,4348,2333,North,94,690,811,Furniture,2015
21-05-2023 05:00,3203,2802,East,85,1074,681,Furniture,401
21-05-2023 06:00,4831,2055,South,61,1356,156,Groceries,2776
21-05-2023 07:00,2241,1175,West,90,1969,508,Electronics,1066
21-05-2023 08:00,1189,591,West,80,1115,677,Groceries,598
21-05-2023 09:00,2440,1592,South,51,1916,157,Clothing,848
21-05-2023 10:00,1980,536,East,65,1931,216,Groceries,1444
21-05-2023 11:00,2698,2287,North,50,1517,524,Clothing,411
21-05-2023 12:00,2715,2687,East,53,1172,918,Furniture,28
21-05-2023 13:00,3593,1701,West,96,1182,120,Electronics,1892
21-05-2023 14:00,1040,2336,North,50,608,178,Electronics,-1296
21-05-2023 15:00,3354,2394,North,96,1151,923,Furniture,960
21-05-2023 16:00,1942,636,South,84,1480,965,Electronics,1306
21-05-2023 17:00,1337,2737,East,62,1626,658,Groceries,-1400
21-05-2023 18:00,2337,2163,North,99,725,985,Clothing,174
21-05-2023 19:00,2098,2889,South,94,852,782,Clothing,-791
21-05-2023 20:00,4000,2082,East,91,1683,695,Clothing,1918
21-05-2023 21:00,3326,1471,West,80,1927,207,Groceries,1855
21-05-2023 22:00,4247,1161,West,69,1847,898,Clothing,3086
21-05-2023 23:00,1895,2790,East,56,644,370,Electronics,-895
22-05-2023 00:00,4733,2310,North,89,1988,787,Clothing,2423
22-05-2023 01:00,3320,914,North,82,1414,929,Groceries,2406
22-05-2023 02:00,3884,842,West,77,1655,575,Electronics,3042
22-05-2023 03:00,3667,645,West,99,1616,169,Furniture,3022
22-05-2023 04:00,2674,822,North,93,772,486,Electronics,1852
22-05-2023 05:00,3909,2669,East,99,1033,265,Groceries,1240
22-05-2023 06:00,4854,1775,West,93,1717,954,Electronics,3079
22-05-2023 07:00,4930,2378,North,69,1693,157,Clothing,2552
22-05-2023 08:00,1930,2858,East,81,959,550,Groceries,-928
22-05-2023 09:00,1288,1100,South,58,1440,344,Furniture,188
22-05-2023 10:00,1723,974,East,83,1534,144,Clothing,749
22-05-2023 11:00,3940,2015,North,63,680,783,Groceries,1925
22-05-2023 12:00,3319,1074,East,53,1755,875,Groceries,2245
22-05-2023 13:00,2953,846,North,78,528,482,Furniture,2107
22-05-2023 14:00,2089,2010,West,64,1031,677,Furniture,79
22-05-2023 15:00,1482,881,South,66,1528,938,Groceries,601
22-05-2023 16:00,1935,1803,West,68,639,800,Furniture,132
22-05-2023 17:00,3295,571,West,87,1551,884,Furniture,2724
22-05-2023 18:00,1155,1617,North,58,597,170,Clothing,-462
22-05-2023 19:00,2070,1896,North,76,761,964,Groceries,174
22-05-2023 20:00,2958,2886,North,98,518,647,Electronics,72
22-05-2023 21:00,3501,1859,North,64,511,338,Clothing,1642
22-05-2023 22:00,3248,1163,West,86,1036,679,Groceries,2085
22-05-2023 23:00,2683,2015,North,77,1988,207,Groceries,668
23-05-2023 00:00,1123,2391,North,99,758,307,Clothing,-1268
23-05-2023 01:00,3048,539,West,53,523,888,Furniture,2509
23-05-2023 02:00,1967,1882,South,70,1531,821,Electronics,85
23-05-2023 03:00,4830,2530,South,83,727,401,Electronics,2300
23-05-2023 04:00,1854,1777,East,68,875,529,Groceries,77
23-05-2023 05:00,1639,1465,West,86,1646,447,Groceries,174
23-05-2023 06:00,3238,2400,North,53,1613,206,Electronics,838
23-05-2023 07:00,2602,2717,East,86,1979,991,Groceries,-115
23-05-2023 08:00,3563,1200,South,81,723,627,Electronics,2363
23-05-2023 09:00,1441,1010,South,94,1235,850,Furniture,431
23-05-2023 10:00,2944,1783,West,97,756,505,Electronics,1161
23-05-2023 11:00,2838,1083,North,61,1014,833,Electronics,1755
23-05-2023 12:00,2829,1483,North,90,1332,355,Electronics,1346
23-05-2023 13:00,3190,958,East,65,1671,400,Groceries,2232
23-05-2023 14:00,4262,2405,South,63,1910,244,Furniture,1857
23-05-2023 15:00,1532,2888,East,50,1200,775,Clothing,-1356
23-05-2023 16:00,3274,2604,East,81,1410,623,Clothing,670
23-05-2023 17:00,2336,2765,East,70,1198,661,Electronics,-429
23-05-2023 18:00,4700,1315,North,53,937,926,Groceries,3385
23-05-2023 19:00,1948,746,South,58,536,459,Clothing,1202
23-05-2023 20:00,4373,1229,East,95,605,623,Clothing,3144
23-05-2023 21:00,4725,2920,South,71,1114,583,Electronics,1805
23-05-2023 22:00,3019,916,South,61,731,289,Electronics,2103
23-05-2023 23:00,1459,1554,East,79,1366,395,Groceries,-95
24-05-2023 00:00,4472,867,East,79,1669,192,Clothing,3605
24-05-2023 01:00,1550,607,West,81,1540,229,Electronics,943
24-05-2023 02:00,1392,1338,North,85,1682,960,Furniture,54
24-05-2023 03:00,4938,917,South,56,1459,583,Furniture,4021
24-05-2023 04:00,2787,2143,East,66,1805,975,Furniture,644
24-05-2023 05:00,1844,1320,East,50,777,508,Electronics,524
24-05-2023 06:00,4278,1921,South,63,624,440,Groceries,2357
24-05-2023 07:00,3257,1182,East,96,1943,313,Furniture,2075
24-05-2023 08:00,2138,755,West,93,1843,429,Furniture,1383
24-05-2023 09:00,4808,1337,South,93,1174,994,Furniture,3471
24-05-2023 10:00,1645,2782,East,87,1214,898,Electronics,-1137
24-05-2023 11:00,4322,1052,South,75,1166,274,Electronics,3270
24-05-2023 12:00,3266,680,East,76,1847,543,Electronics,2586
24-05-2023 13:00,3454,656,East,94,1412,300,Furniture,2798
24-05-2023 14:00,2466,1977,North,65,894,716,Electronics,489
24-05-2023 15:00,4674,1070,South,95,1272,842,Electronics,3604
24-05-2023 16:00,2377,1356,North,56,685,197,Groceries,1021
24-05-2023 17:00,3935,2284,East,81,965,202,Electronics,1651
24-05-2023 18:00,3605,2227,South,74,1580,652,Clothing,1378
24-05-2023 19:00,3597,1547,South,80,957,250,Electronics,2050
24-05-2023 20:00,1141,1996,West,65,1500,367,Electronics,-855
24-05-2023 21:00,3659,1923,West,90,1731,938,Clothing,1736
24-05-2023 22:00,1500,1091,East,63,573,451,Clothing,409
24-05-2023 23:00,1839,2681,East,74,1608,566,Electronics,-842
25-05-2023 00:00,3749,920,East,79,1131,377,Groceries,2829
25-05-2023 01:00,4618,2760,East,56,1537,667,Furniture,1858
25-05-2023 02:00,2682,847,West,61,1339,115,Clothing,1835
25-05-2023 03:00,2565,665,South,52,1411,555,Groceries,1900
25-05-2023 04:00,3046,1436,North,76,1293,833,Electronics,1610
25-05-2023 05:00,4917,847,South,95,548,278,Electronics,4070
25-05-2023 06:00,2530,897,South,68,1949,233,Clothing,1633
25-05-2023 07:00,1595,1082,West,92,1465,357,Clothing,513
25-05-2023 08:00,2904,2100,South,86,858,161,Groceries,804
25-05-2023 09:00,1280,807,South,94,741,581,Electronics,473
25-05-2023 10:00,1423,598,East,91,1576,576,Clothing,825
25-05-2023 11:00,3903,1765,North,56,1592,734,Clothing,2138
25-05-2023 12:00,1269,657,South,98,555,141,Furniture,612
25-05-2023 13:00,1153,1053,South,65,1378,472,Clothing,100
25-05-2023 14:00,3661,1150,North,81,1979,472,Groceries,2511
25-05-2023 15:00,2750,2774,East,57,754,398,Electronics,-24
25-05-2023 16:00,1661,2970,West,98,504,151,Clothing,-1309
25-05-2023 17:00,2967,2790,West,62,1575,478,Furniture,177
25-05-2023 18:00,1082,1568,South,60,828,411,Clothing,-486
25-05-2023 19:00,4693,1995,East,69,597,678,Clothing,2698
25-05-2023 20:00,3994,2918,West,67,1684,158,Electronics,1076
25-05-2023 21:00,3946,2378,West,86,1929,403,Furniture,1568
25-05-2023 22:00,2449,1233,West,55,1480,134,Groceries,1216
25-05-2023 23:00,2298,2450,West,69,1502,747,Groceries,-152
26-05-2023 00:00,4784,591,West,81,1282,687,Electronics,4193
26-05-2023 01:00,3331,2719,South,95,1076,853,Groceries,612
26-05-2023 02:00,1979,2127,West,93,826,592,Groceries,-148
26-05-2023 03:00,3220,1715,South,78,742,590,Clothing,1505
26-05-2023 04:00,4398,1600,North,53,866,899,Groceries,2798
26-05-2023 05:00,4789,1804,North,56,1273,320,Furniture,2985
26-05-2023 06:00,4134,1887,East,92,1223,912,Clothing,2247
26-05-2023 07:00,4144,678,South,69,1965,696,Groceries,3466
26-05-2023 08:00,3810,2785,East,83,1677,222,Furniture,1025
26-05-2023 09:00,2659,779,North,85,733,806,Clothing,1880
26-05-2023 10:00,2398,1542,North,56,1151,201,Furniture,856
26-05-2023 11:00,1632,2118,North,82,832,894,Electronics,-486
26-05-2023 12:00,2531,870,North,64,994,986,Electronics,1661
26-05-2023 13:00,1786,2300,West,81,1638,614,Groceries,-514
26-05-2023 14:00,3990,2203,North,71,868,412,Furniture,1787
26-05-2023 15:00,4059,2768,West,89,1856,605,Clothing,1291
26-05-2023 16:00,1397,803,West,78,1653,593,Furniture,594
26-05-2023 17:00,2143,1848,East,74,1701,858,Furniture,295
26-05-2023 18:00,1933,1960,West,54,594,759,Electronics,-27
26-05-2023 19:00,2460,2985,East,63,1840,298,Electronics,-525
26-05-2023 20:00,2852,1693,West,99,1406,732,Groceries,1159
26-05-2023 21:00,3723,2922,West,84,1624,780,Furniture,801
26-05-2023 22:00,3983,2928,North,51,1719,612,Furniture,1055
26-05-2023 23:00,3512,2561,South,74,1301,429,Clothing,951
27-05-2023 00:00,1285,1168,West,65,707,720,Clothing,117
27-05-2023 01:00,1264,999,South,95,1106,999,Electronics,265
27-05-2023 02:00,3367,1914,South,65,972,426,Furniture,1453
27-05-2023 03:00,3720,2072,South,60,1531,109,Groceries,1648
27-05-2023 04:00,4447,1029,West,98,635,226,Electronics,3418
27-05-2023 05:00,3867,2506,South,84,1109,768,Furniture,1361
27-05-2023 06:00,3136,1719,West,72,1410,330,Electronics,1417
27-05-2023 07:00,2677,1254,North,54,760,114,Groceries,1423
27-05-2023 08:00,2226,2847,West,84,1670,886,Furniture,-621
27-05-2023 09:00,1820,1314,East,78,957,586,Groceries,506
27-05-2023 10:00,2762,1226,North,96,1961,541,Furniture,1536
27-05-2023 11:00,4048,1230,South,54,1936,977,Furniture,2818
27-05-2023 12:00,3381,1327,South,52,731,657,Groceries,2054
27-05-2023 13:00,3269,1831,East,55,600,373,Clothing,1438
27-05-2023 14:00,1040,2546,North,72,646,717,Groceries,-1506
27-05-2023 15:00,2731,1374,East,95,1216,102,Groceries,1357
27-05-2023 16:00,1067,2678,South,51,1006,425,Electronics,-1611
27-05-2023 17:00,1987,2503,West,67,1057,352,Groceries,-516
27-05-2023 18:00,2799,2177,South,79,603,633,Groceries,622
27-05-2023 19:00,3561,1107,East,87,835,154,Electronics,2454
27-05-2023 20:00,4944,2573,West,54,945,985,Clothing,2371
27-05-2023 21:00,4708,1977,West,95,1233,547,Groceries,2731
27-05-2023 22:00,4693,1134,South,98,943,396,Electronics,3559
27-05-2023 23:00,2621,1709,West,60,617,721,Clothing,912
28-05-2023 00:00,2655,983,North,50,1428,472,Clothing,1672
28-05-2023 01:00,4198,1574,South,59,1222,834,Groceries,2624
28-05-2023 02:00,2278,2414,South,90,1066,568,Clothing,-136
28-05-2023 03:00,1694,2552,North,93,587,859,Groceries,-858
28-05-2023 04:00,4087,1088,South,75,975,235,Clothing,2999
28-05-2023 05:00,3524,2755,East,82,794,932,Clothing,769
28-05-2023 06:00,2085,2804,East,76,1219,998,Clothing,-719
28-05-2023 07:00,3928,1728,South,99,1904,345,Groceries,2200
28-05-2023 08:00,3479,2473,North,61,1494,169,Clothing,1006
28-05-2023 09:00,2693,2558,West,51,1806,580,Furniture,135
28-05-2023 10:00,3315,1448,North,50,1343,629,Electronics,1867
28-05-2023 11:00,2058,2555,East,50,1185,589,Electronics,-497
28-05-2023 12:00,1778,2579,South,82,1138,602,Furniture,-801
28-05-2023 13:00,4647,2507,North,71,1679,797,Clothing,2140
28-05-2023 14:00,1493,2241,West,61,1703,216,Furniture,-748
28-05-2023 15:00,2585,886,West,88,1460,356,Groceries,1699
28-05-2023 16:00,2492,1751,West,85,1434,889,Electronics,741
28-05-2023 17:00,2790,2290,West,70,1389,706,Clothing,500
28-05-2023 18:00,1660,1998,North,69,1413,527,Electronics,-338
28-05-2023 19:00,2348,706,West,85,1610,214,Furniture,1642
28-05-2023 20:00,2327,2318,East,75,905,593,Furniture,9
28-05-2023 21:00,2299,2280,West,96,1790,161,Electronics,19
28-05-2023 22:00,4940,2895,East,80,1587,886,Electronics,2045
28-05-2023 23:00,2986,1292,North,50,618,926,Electronics,1694
29-05-2023 00:00,4755,2781,East,87,840,596,Electronics,1974
29-05-2023 01:00,4060,2224,North,63,812,735,Furniture,1836
29-05-2023 02:00,3044,1505,West,75,662,179,Clothing,1539
29-05-2023 03:00,4272,1441,South,95,792,758,Electronics,2831
29-05-2023 04:00,4516,1665,East,91,1189,584,Clothing,2851
29-05-2023 05:00,2928,2723,East,56,1900,121,Electronics,205
29-05-2023 06:00,2347,2177,South,61,1924,694,Groceries,170
29-05-2023 07:00,2058,948,North,73,1172,423,Clothing,1110
29-05-2023 08:00,1976,1091,North,68,1923,616,Groceries,885
29-05-2023 09:00,1481,581,West,58,898,360,Furniture,900
29-05-2023 10:00,1727,2682,East,84,1408,891,Groceries,-955
29-05-2023 11:00,3527,1906,North,53,986,228,Furniture,1621
29-05-2023 12:00,4136,1980,West,94,1547,725,Electronics,2156
29-05-2023 13:00,2031,2987,North,91,1582,383,Furniture,-956
29-05-2023 14:00,4372,1579,South,81,1248,146,Electronics,2793
29-05-2023 15:00,1342,918,South,95,739,952,Electronics,424
29-05-2023 16:00,4502,587,South,55,810,287,Electronics,3915
29-05-2023 17:00,2447,714,West,77,820,118,Furniture,1733
29-05-2023 18:00,3379,2258,East,77,1171,698,Electronics,1121
29-05-2023 19:00,3485,2020,South,89,1071,753,Groceries,1465
29-05-2023 20:00,4659,2217,South,78,913,862,Groceries,2442
29-05-2023 21:00,3221,2792,North,91,1845,937,Electronics,429
29-05-2023 22:00,3606,2001,South,54,901,981,Electronics,1605
29-05-2023 23:00,1526,808,East,54,558,107,Clothing,718
30-05-2023 00:00,2896,730,West,86,552,136,Furniture,2166
30-05-2023 01:00,1658,654,South,90,1587,697,Clothing,1004
30-05-2023 02:00,3073,1698,West,77,1132,171,Groceries,1375
30-05-2023 03:00,1819,614,West,90,1642,480,Furniture,1205
30-05-2023 04:00,3652,1913,East,96,785,365,Groceries,1739
30-05-2023 05:00,1405,810,North,58,517,166,Furniture,595
30-05-2023 06:00,3279,1492,North,78,1528,752,Furniture,1787
30-05-2023 07:00,3580,2847,West,63,1915,906,Furniture,733
30-05-2023 08:00,4890,1541,South,87,659,163,Groceries,3349
30-05-2023 09:00,2573,511,West,89,641,129,Electronics,2062
30-05-2023 10:00,2811,1927,North,83,896,999,Groceries,884
30-05-2023 11:00,1504,2779,South,86,1541,656,Furniture,-1275
30-05-2023 12:00,4740,2513,North,98,1079,745,Groceries,2227
30-05-2023 13:00,1178,1229,East,91,1637,115,Groceries,-51
30-05-2023 14:00,1131,1801,North,63,1033,377,Clothing,-670
30-05-2023 15:00,2846,1876,South,67,1410,830,Furniture,970
30-05-2023 16:00,2478,2536,South,82,960,376,Groceries,-58
30-05-2023 17:00,3395,2850,West,83,785,320,Furniture,545
30-05-2023 18:00,3587,1040,South,77,1528,292,Groceries,2547
30-05-2023 19:00,1771,576,East,85,628,769,Clothing,1195
30-05-2023 20:00,2429,523,North,94,1455,123,Groceries,1906
30-05-2023 21:00,3123,1538,West,97,1170,931,Electronics,1585
30-05-2023 22:00,1578,1175,West,86,998,240,Furniture,403
30-05-2023 23:00,3901,2894,South,72,775,833,Clothing,1007
31-05-2023 00:00,2515,671,East,91,1606,125,Groceries,1844
31-05-2023 01:00,1193,2392,West,66,1641,197,Clothing,-1199
31-05-2023 02:00,3007,988,East,60,528,375,Groceries,2019
31-05-2023 03:00,2185,1985,East,81,1504,672,Furniture,200
31-05-2023 04:00,3394,2925,North,86,1881,991,Groceries,469
31-05-2023 05:00,3998,2919,North,64,1149,342,Clothing,1079
31-05-2023 06:00,2384,1256,North,53,1680,532,Electronics,1128
31-05-2023 07:00,2792,2929,East,88,530,108,Clothing,-137
31-05-2023 08:00,4655,654,North,79,1342,995,Electronics,4001
31-05-2023 09:00,2110,756,West,59,1809,968,Electronics,1354
31-05-2023 10:00,4333,2279,West,72,835,371,Furniture,2054
31-05-2023 11:00,3261,1173,South,73,1069,871,Clothing,2088
31-05-2023 12:00,4736,2615,East,85,812,131,Groceries,2121
31-05-2023 13:00,4793,2891,North,54,1098,951,Electronics,1902
31-05-2023 14:00,2936,1172,West,86,1646,704,Clothing,1764
31-05-2023 15:00,3620,2938,East,92,1364,578,Furniture,682
31-05-2023 16:00,1779,1972,East,68,870,227,Groceries,-193
31-05-2023 17:00,1261,758,North,86,1304,848,Groceries,503
31-05-2023 18:00,1729,806,East,57,813,116,Groceries,923
31-05-2023 19:00,1282,1618,North,56,527,652,Clothing,-336
31-05-2023 20:00,4719,745,North,89,1678,572,Clothing,3974
31-05-2023 21:00,2490,2158,North,62,1465,400,Groceries,332
31-05-2023 22:00,4451,686,East,86,1753,883,Furniture,3765
31-05-2023 23:00,1361,2297,East,76,1529,887,Groceries,-936
01-06-2023 00:00,4520,1424,North,67,972,141,Groceries,3096
01-06-2023 01:00,1440,1284,East,73,1841,877,Furniture,156
01-06-2023 02:00,3140,2095,North,90,1748,151,Furniture,1045
01-06-2023 03:00,2644,2955,South,51,1556,287,Furniture,-311
01-06-2023 04:00,3800,1860,East,65,588,250,Groceries,1940
01-06-2023 05:00,1866,840,East,63,1857,343,Furniture,1026
01-06-2023 06:00,2447,1062,South,66,539,900,Clothing,1385
01-06-2023 07:00,1141,1150,South,55,1180,590,Furniture,-9
01-06-2023 08:00,2314,1693,South,84,874,226,Groceries,621
01-06-2023 09:00,2455,568,North,66,1821,816,Electronics,1887
01-06-2023 10:00,3796,2083,North,94,1497,508,Electronics,1713
01-06-2023 11:00,2875,2928,West,87,892,917,Clothing,-53
01-06-2023 12:00,2847,2604,South,89,1541,968,Electronics,243
01-06-2023 13:00,2712,1800,West,55,631,711,Electronics,912
01-06-2023 14:00,3700,1622,North,97,789,443,Electronics,2078
01-06-2023 15:00,1700,1415,East,87,1305,690,Clothing,285
01-06-2023 16:00,1997,2872,South,98,708,794,Electronics,-875
01-06-2023 17:00,3096,960,East,70,826,197,Groceries,2136
01-06-2023 18:00,2325,2726,North,84,1491,167,Electronics,-401
01-06-2023 19:00,1880,1343,South,72,1002,945,Furniture,537
01-06-2023 20:00,2213,1073,West,61,778,999,Electronics,1140
01-06-2023 21:00,2159,618,West,78,1905,127,Electronics,1541
01-06-2023 22:00,1554,1145,North,76,1287,128,Groceries,409
01-06-2023 23:00,1403,1978,East,55,1506,949,Clothing,-575
02-06-2023 00:00,1891,2573,North,70,1451,733,Clothing,-682
02-06-2023 01:00,3912,2013,East,56,1832,311,Electronics,1899
02-06-2023 02:00,1601,2531,North,92,776,787,Groceries,-930
02-06-2023 03:00,2830,1531,West,90,1599,716,Electronics,1299
02-06-2023 04:00,1340,1468,East,65,797,579,Clothing,-128
02-06-2023 05:00,4828,2510,North,54,1901,171,Clothing,2318
02-06-2023 06:00,2968,2039,South,64,932,590,Furniture,929
02-06-2023 07:00,1703,2696,West,70,1509,209,Furniture,-993
02-06-2023 08:00,1317,2011,West,53,1635,212,Groceries,-694
02-06-2023 09:00,3665,1548,South,54,1595,496,Groceries,2117
02-06-2023 10:00,2386,1154,North,56,816,331,Clothing,1232
02-06-2023 11:00,4893,2454,East,84,1544,142,Clothing,2439
02-06-2023 12:00,3429,1054,West,85,1711,364,Clothing,2375
02-06-2023 13:00,3280,924,North,64,620,907,Electronics,2356
02-06-2023 14:00,2800,792,South,77,1865,145,Furniture,2008
02-06-2023 15:00,2367,1708,East,51,1152,669,Furniture,659
02-06-2023 16:00,2572,930,North,54,803,324,Clothing,1642
02-06-2023 17:00,1816,816,North,56,1435,751,Clothing,1000
02-06-2023 18:00,1552,897,West,71,1970,200,Furniture,655
02-06-2023 19:00,4600,1847,West,98,1220,380,Groceries,2753
02-06-2023 20:00,1855,2088,East,80,995,337,Clothing,-233
02-06-2023 21:00,2812,1095,North,81,684,700,Clothing,1717
02-06-2023 22:00,3866,2623,South,57,1387,345,Groceries,1243
02-06-2023 23:00,4642,2443,South,90,1307,790,Clothing,2199
03-06-2023 00:00,1182,1415,East,91,831,991,Furniture,-233
03-06-2023 01:00,4112,1755,North,60,1212,842,Furniture,2357
03-06-2023 02:00,2574,1475,West,50,1075,198,Groceries,1099
03-06-2023 03:00,1396,1575,North,96,849,826,Furniture,-179
03-06-2023 04:00,2727,1744,West,89,1337,299,Groceries,983
03-06-2023 05:00,3826,1951,South,68,819,355,Groceries,1875
03-06-2023 06:00,2517,1666,East,93,1036,536,Furniture,851
03-06-2023 07:00,4730,2528,East,87,911,593,Groceries,2202
03-06-2023 08:00,1906,862,East,91,1405,535,Furniture,1044
03-06-2023 09:00,2356,2929,West,86,1679,806,Groceries,-573
03-06-2023 10:00,3174,2818,South,56,1032,991,Groceries,356
03-06-2023 11:00,4629,2845,South,88,1001,123,Groceries,1784
03-06-2023 12:00,4628,733,East,74,1677,462,Furniture,3895
03-06-2023 13:00,1000,2231,East,71,1413,369,Clothing,-1231
03-06-2023 14:00,4239,526,West,76,1591,889,Electronics,3713
03-06-2023 15:00,4691,1994,West,90,1564,837,Clothing,2697
03-06-2023 16:00,1018,592,North,96,1026,327,Groceries,426
03-06-2023 17:00,4403,808,West,87,1692,227,Furniture,3595
03-06-2023 18:00,1583,551,North,97,1210,642,Groceries,1032
03-06-2023 19:00,1455,818,East,88,1249,952,Clothing,637
03-06-2023 20:00,4004,2492,South,64,1455,862,Electronics,1512
03-06-2023 21:00,3036,680,West,51,611,157,Clothing,2356
03-06-2023 22:00,2132,2092,South,57,962,424,Furniture,40
03-06-2023 23:00,4339,1146,West,93,551,758,Furniture,3193
04-06-2023 00:00,3492,2461,West,92,754,205,Clothing,1031
04-06-2023 01:00,4311,1783,North,55,1681,536,Clothing,2528
04-06-2023 02:00,2952,2744,West,69,799,184,Electronics,208
04-06-2023 03:00,4372,2802,East,76,1457,101,Groceries,1570
04-06-2023 04:00,3649,2524,South,94,926,536,Furniture,1125
04-06-2023 05:00,3150,835,West,72,1489,550,Furniture,2315
04-06-2023 06:00,1987,2076,South,97,806,914,Electronics,-89
04-06-2023 07:00,4321,2025,South,89,598,982,Furniture,2296
04-06-2023 08:00,4524,1489,South,66,620,664,Furniture,3035
04-06-2023 09:00,1519,1778,West,62,1553,540,Clothing,-259
04-06-2023 10:00,4224,1013,North,53,729,321,Clothing,3211
04-06-2023 11:00,1858,2529,South,69,1150,124,Electronics,-671
04-06-2023 12:00,1173,741,South,91,1777,134,Furniture,432
04-06-2023 13:00,2366,2696,West,74,1927,768,Electronics,-330
04-06-2023 14:00,4741,2233,West,71,1554,442,Groceries,2508
04-06-2023 15:00,4052,2759,East,97,1685,465,Groceries,1293
04-06-2023 16:00,3478,1167,East,66,1955,756,Electronics,2311
04-06-2023 17:00,1726,1093,North,89,1679,435,Furniture,633
04-06-2023 18:00,4760,2678,North,60,1846,532,Groceries,2082
04-06-2023 19:00,2710,755,North,74,1128,556,Furniture,1955
04-06-2023 20:00,2875,2002,North,54,1714,998,Clothing,873
04-06-2023 21:00,3897,1060,South,70,1699,889,Electronics,2837
04-06-2023 22:00,2681,2610,West,75,1447,578,Groceries,71
04-06-2023 23:00,2347,1834,East,65,1016,497,Furniture,513
05-06-2023 00:00,1989,906,South,89,1344,998,Clothing,1083
05-06-2023 01:00,4744,2360,West,70,1332,905,Electronics,2384
05-06-2023 02:00,3686,2562,West,97,1319,442,Groceries,1124
05-06-2023 03:00,1419,2210,South,81,1310,888,Clothing,-791
05-06-2023 04:00,1593,758,South,53,1261,790,Electronics,835
05-06-2023 05:00,3532,1222,East,87,1862,379,Groceries,2310
05-06-2023 06:00,4730,1782,North,57,818,451,Furniture,2948
05-06-2023 07:00,2774,1113,North,58,610,912,Clothing,1661
05-06-2023 08:00,3459,2194,East,94,1306,296,Clothing,1265
05-06-2023 09:00,1935,2478,East,66,1996,324,Furniture,-543
05-06-2023 10:00,2107,1312,North,90,1540,146,Clothing,795
05-06-2023 11:00,2136,2286,South,62,1743,284,Clothing,-150
05-06-2023 12:00,4808,830,North,58,986,261,Electronics,3978
05-06-2023 13:00,1331,2712,West,55,1310,742,Furniture,-1381
05-06-2023 14:00,4449,1716,West,76,1828,394,Clothing,2733
05-06-2023 15:00,4826,2044,East,91,1016,191,Furniture,2782
05-06-2023 16:00,3702,1897,North,86,1652,686,Electronics,1805
05-06-2023 17:00,3088,886,North,88,1334,749,Electronics,2202
05-06-2023 18:00,2793,2018,West,92,1123,267,Furniture,775
05-06-2023 19:00,1958,2317,North,73,1547,357,Furniture,-359
05-06-2023 20:00,4868,2317,East,58,1655,849,Groceries,2551
05-06-2023 21:00,1104,2314,East,91,1055,656,Electronics,-1210
05-06-2023 22:00,1201,2875,West,60,1844,408,Clothing,-1674
05-06-2023 23:00,3497,2015,North,84,996,748,Electronics,1482
06-06-2023 00:00,2842,1740,North,78,1387,714,Electronics,1102
06-06-2023 01:00,2866,819,West,57,881,228,Groceries,2047
06-06-2023 02:00,2996,898,South,66,715,772,Furniture,2098
06-06-2023 03:00,2289,2414,South,56,1255,649,Electronics,-125
06-06-2023 04:00,1909,604,North,61,1042,668,Groceries,1305
06-06-2023 05:00,1209,1195,East,97,1415,260,Furniture,14
06-06-2023 06:00,1562,829,South,64,1534,275,Electronics,733
06-06-2023 07:00,4189,1159,North,78,581,870,Groceries,3030
06-06-2023 08:00,3760,1320,South,94,1493,387,Electronics,2440
06-06-2023 09:00,4448,2472,West,99,1679,504,Clothing,1976
06-06-2023 10:00,4622,2293,South,99,665,935,Furniture,2329
06-06-2023 11:00,2563,2861,South,73,707,756,Furniture,-298
06-06-2023 12:00,1770,961,West,86,523,679,Electronics,809
06-06-2023 13:00,4155,2107,East,63,1306,439,Groceries,2048
06-06-2023 14:00,3501,2175,North,60,1386,367,Groceries,1326
06-06-2023 15:00,3714,2957,East,84,1190,317,Clothing,757
06-06-2023 16:00,1628,2574,East,66,831,912,Clothing,-946
06-06-2023 17:00,4585,770,South,76,1501,263,Groceries,3815
06-06-2023 18:00,2628,884,North,93,740,947,Furniture,1744
06-06-2023 19:00,2701,559,South,52,1335,790,Clothing,2142
06-06-2023 20:00,1386,1630,West,51,680,490,Electronics,-244
06-06-2023 21:00,2935,719,East,53,1816,516,Electronics,2216
06-06-2023 22:00,4421,1964,East,67,1606,147,Furniture,2457
06-06-2023 23:00,3343,2406,West,69,589,293,Furniture,937
07-06-2023 00:00,3305,2095,North,70,938,900,Clothing,1210
07-06-2023 01:00,2104,595,East,63,1042,817,Electronics,1509
07-06-2023 02:00,1267,1488,East,57,692,183,Furniture,-221
07-06-2023 03:00,3466,1612,North,51,987,712,Electronics,1854
07-06-2023 04:00,3282,2445,South,75,1111,766,Clothing,837
07-06-2023 05:00,2856,2778,West,68,1872,146,Furniture,78
07-06-2023 06:00,4382,1467,North,91,1612,333,Groceries,2915
07-06-2023 07:00,4884,2822,West,77,1454,952,Electronics,2062
07-06-2023 08:00,2998,745,West,78,1646,398,Furniture,2253
07-06-2023 09:00,4033,2658,East,54,1897,947,Clothing,1375
07-06-2023 10:00,2380,733,North,92,1570,246,Groceries,1647
07-06-2023 11:00,2236,2964,West,77,1956,295,Furniture,-728
07-06-2023 12:00,1573,1651,South,90,645,121,Electronics,-78
07-06-2023 13:00,1048,1760,West,97,1526,293,Electronics,-712
07-06-2023 14:00,2150,1302,East,75,1837,485,Clothing,848
07-06-2023 15:00,1222,1917,South,54,826,463,Electronics,-695
07-06-2023 16:00,3968,1154,South,64,1487,965,Groceries,2814
07-06-2023 17:00,4350,2942,North,95,1604,373,Clothing,1408
07-06-2023 18:00,2431,610,South,58,652,483,Clothing,1821
07-06-2023 19:00,2528,589,North,81,901,307,Furniture,1939
07-06-2023 20:00,4365,1262,North,75,1319,374,Clothing,3103
07-06-2023 21:00,2819,1803,South,86,987,828,Furniture,1016
07-06-2023 22:00,3324,1856,North,64,566,595,Clothing,1468
07-06-2023 23:00,2461,2679,North,90,588,638,Furniture,-218
08-06-2023 00:00,2130,1536,South,53,1658,626,Furniture,594
08-06-2023 01:00,2681,1964,East,85,701,258,Furniture,717
08-06-2023 02:00,3467,597,West,69,927,825,Groceries,2870
08-06-2023 03:00,3658,1643,North,76,1439,559,Furniture,2015
08-06-2023 04:00,4500,792,North,70,1702,493,Groceries,3708
08-06-2023 05:00,1374,2339,South,71,838,538,Furniture,-965
08-06-2023 06:00,3120,2234,West,56,578,478,Furniture,886
08-06-2023 07:00,3021,1524,West,96,877,962,Groceries,1497
08-06-2023 08:00,4705,2797,North,80,664,263,Groceries,1908
08-06-2023 09:00,2053,1151,South,66,1248,738,Groceries,902
08-06-2023 10:00,4259,2696,East,99,1436,429,Groceries,1563
08-06-2023 11:00,4435,2591,West,56,654,669,Furniture,1844
08-06-2023 12:00,2889,2406,East,68,1646,246,Furniture,483
08-06-2023 13:00,2823,2221,South,77,1725,867,Clothing,602
08-06-2023 14:00,2474,1567,East,59,1563,209,Clothing,907
08-06-2023 15:00,3242,2709,South,76,668,493,Furniture,533
08-06-2023 16:00,2179,2316,North,62,1593,660,Clothing,-137
08-06-2023 17:00,4243,752,East,51,1291,281,Groceries,3491
08-06-2023 18:00,3894,631,North,71,1853,672,Clothing,3263
08-06-2023 19:00,2064,2407,North,69,1963,542,Groceries,-343
08-06-2023 20:00,4134,2410,South,92,1922,846,Furniture,1724
08-06-2023 21:00,3070,2179,East,54,1502,853,Clothing,891
08-06-2023 22:00,1359,1632,West,55,853,229,Groceries,-273
08-06-2023 23:00,4146,1558,East,84,827,942,Furniture,2588
09-06-2023 00:00,3607,2425,West,50,997,875,Furniture,1182
09-06-2023 01:00,3719,2822,North,84,1942,502,Groceries,897
09-06-2023 02:00,3041,686,North,52,844,604,Groceries,2355
09-06-2023 03:00,4896,1448,South,85,1142,819,Furniture,3448
09-06-2023 04:00,2141,2790,West,56,1288,753,Electronics,-649
09-06-2023 05:00,2635,763,East,78,876,121,Electronics,1872
09-06-2023 06:00,2403,2497,South,64,1818,116,Groceries,-94
09-06-2023 07:00,2943,1021,South,60,1811,974,Clothing,1922
09-06-2023 08:00,1678,2064,South,67,1777,930,Groceries,-386
09-06-2023 09:00,4361,1282,East,93,933,733,Furniture,3079
09-06-2023 10:00,3487,1034,South,53,1000,381,Groceries,2453
09-06-2023 11:00,4739,709,East,73,1608,326,Electronics,4030
09-06-2023 12:00,3980,2593,South,60,1020,519,Groceries,1387
09-06-2023 13:00,1006,2063,West,55,1061,472,Electronics,-1057
09-06-2023 14:00,4267,525,North,67,1012,400,Clothing,3742
09-06-2023 15:00,3468,674,West,64,1015,385,Clothing,2794
09-06-2023 16:00,2591,2039,West,52,996,215,Clothing,552
09-06-2023 17:00,1832,1834,South,66,1101,248,Groceries,-2
09-06-2023 18:00,4264,821,West,82,1514,503,Electronics,3443
09-06-2023 19:00,3606,2102,West,83,1685,781,Groceries,1504
09-06-2023 20:00,4219,1658,West,79,1166,189,Clothing,2561
09-06-2023 21:00,2810,554,South,68,864,218,Groceries,2256
09-06-2023 22:00,4740,2066,East,58,1948,795,Electronics,2674
09-06-2023 23:00,4273,2109,North,89,1466,875,Furniture,2164
10-06-2023 00:00,4515,2372,North,93,863,838,Electronics,2143
10-06-2023 01:00,1913,2694,East,80,607,192,Clothing,-781
10-06-2023 02:00,3011,2008,East,76,1537,728,Clothing,1003
10-06-2023 03:00,2442,2567,West,96,1546,546,Clothing,-125
10-06-2023 04:00,2450,832,North,74,1122,411,Groceries,1618
10-06-2023 05:00,4054,2078,East,56,820,417,Electronics,1976
10-06-2023 06:00,2502,1406,West,97,1009,220,Groceries,1096
10-06-2023 07:00,4546,1410,North,56,1171,416,Clothing,3136
10-06-2023 08:00,1125,900,South,69,1564,237,Electronics,225
10-06-2023 09:00,3442,1449,South,93,803,842,Furniture,1993
10-06-2023 10:00,1816,1829,North,98,1468,917,Clothing,-13
10-06-2023 11:00,3928,2575,North,92,1938,759,Electronics,1353
10-06-2023 12:00,2829,2410,South,85,1973,383,Electronics,419
10-06-2023 13:00,1575,600,South,68,1917,753,Clothing,975
10-06-2023 14:00,3372,1050,North,51,864,943,Furniture,2322
10-06-2023 15:00,2415,2900,West,83,1237,619,Electronics,-485
10-06-2023 16:00,1929,2205,East,66,1488,604,Electronics,-276
10-06-2023 17:00,4759,2843,East,73,1520,490,Furniture,1916
10-06-2023 18:00,4699,852,North,58,1952,104,Clothing,3847
10-06-2023 19:00,2463,1518,East,50,651,868,Electronics,945
10-06-2023 20:00,4275,1679,South,91,758,466,Clothing,2596
10-06-2023 21:00,4557,1597,South,77,1206,940,Groceries,2960
10-06-2023 22:00,1832,1479,East,64,722,591,Groceries,353
10-06-2023 23:00,2054,1855,North,70,1789,857,Furniture,199
11-06-2023 00:00,4459,1238,South,64,729,565,Clothing,3221
11-06-2023 01:00,2648,1476,West,72,938,334,Electronics,1172
11-06-2023 02:00,2900,1871,West,51,649,461,Furniture,1029
11-06-2023 03:00,2457,2780,South,95,1409,621,Groceries,-323
11-06-2023 04:00,3884,2301,South,85,1980,341,Clothing,1583
11-06-2023 05:00,3973,2649,East,99,1477,541,Furniture,1324
11-06-2023 06:00,2399,1452,North,58,1659,932,Furniture,947
11-06-2023 07:00,4415,980,East,51,1134,287,Clothing,3435
11-06-2023 08:00,1442,1737,North,51,898,503,Electronics,-295
11-06-2023 09:00,4650,607,West,67,1121,925,Electronics,4043
11-06-2023 10:00,3122,1472,West,66,642,526,Electronics,1650
11-06-2023 11:00,1556,2126,North,90,1447,512,Clothing,-570
11-06-2023 12:00,4843,1203,East,57,1593,613,Groceries,3640
11-06-2023 13:00,4737,2882,South,83,553,253,Furniture,1855
11-06-2023 14:00,2178,2633,North,83,1343,302,Clothing,-455
11-06-2023 15:00,4501,1374,East,54,1437,316,Electronics,3127
11-06-2023 16:00,3037,1947,West,93,1926,581,Electronics,1090
11-06-2023 17:00,1362,2911,South,78,1051,414,Furniture,-1549
11-06-2023 18:00,3495,2607,West,77,1550,716,Furniture,888
11-06-2023 19:00,2257,1773,North,65,798,100,Furniture,484
11-06-2023 20:00,4634,1059,West,63,1191,865,Furniture,3575
11-06-2023 21:00,2841,616,West,51,1057,602,Furniture,2225
11-06-2023 22:00,3309,1373,North,89,1843,898,Clothing,1936
11-06-2023 23:00,2850,1467,South,53,944,905,Electronics,1383
12-06-2023 00:00,3172,2068,North,90,597,377,Electronics,1104
12-06-2023 01:00,1910,543,East,80,1649,293,Clothing,1367
12-06-2023 02:00,1244,1008,North,75,557,868,Groceries,236
12-06-2023 03:00,1541,2511,North,76,676,861,Electronics,-970
12-06-2023 04:00,3532,1688,South,83,1218,347,Groceries,1844
12-06-2023 05:00,3169,1815,East,80,1808,187,Groceries,1354
12-06-2023 06:00,3172,1348,West,97,1165,533,Groceries,1824
12-06-2023 07:00,2572,2379,West,60,1550,519,Groceries,193
12-06-2023 08:00,3217,1416,West,57,1974,352,Electronics,1801
12-06-2023 09:00,1123,1298,West,61,822,528,Electronics,-175
12-06-2023 10:00,4940,1375,South,84,1174,263,Clothing,3565
12-06-2023 11:00,4106,2260,East,94,1773,594,Electronics,1846
12-06-2023 12:00,4158,2833,South,83,1893,261,Clothing,1325
12-06-2023 13:00,3693,1318,North,62,1345,606,Groceries,2375
12-06-2023 14:00,2731,2668,East,76,589,364,Clothing,63
12-06-2023 15:00,1785,1444,East,57,630,209,Clothing,341
12-06-2023 16:00,3043,1406,West,96,1552,951,Electronics,1637
12-06-2023 17:00,3248,512,West,70,1161,999,Clothing,2736
12-06-2023 18:00,3416,1102,West,90,1609,818,Groceries,2314
12-06-2023 19:00,1796,699,West,60,557,418,Electronics,1097
12-06-2023 20:00,1076,2291,North,71,1580,231,Electronics,-1215
12-06-2023 21:00,1058,947,West,70,1493,232,Electronics,111
12-06-2023 22:00,3478,2311,South,77,1917,493,Furniture,1167
12-06-2023 23:00,3685,1340,East,52,1548,719,Groceries,2345
13-06-2023 00:00,2523,1089,North,56,689,783,Clothing,1434
13-06-2023 01:00,2936,1653,North,63,1458,651,Furniture,1283
13-06-2023 02:00,3156,2590,East,64,575,903,Electronics,566
13-06-2023 03:00,4807,1019,East,58,870,134,Furniture,3788
13-06-2023 04:00,4055,1536,East,92,1398,670,Furniture,2519
13-06-2023 05:00,2301,1224,North,56,1350,804,Clothing,1077
13-06-2023 06:00,1067,1487,South,61,1005,821,Groceries,-420
13-06-2023 07:00,4140,1302,South,68,682,471,Furniture,2838
13-06-2023 08:00,4236,2849,East,76,653,130,Groceries,1387
13-06-2023 09:00,4560,1026,North,67,1792,273,Groceries,3534
13-06-2023 10:00,3352,2165,West,62,1402,916,Electronics,1187
13-06-2023 11:00,2932,1638,North,92,1801,489,Electronics,1294
13-06-2023 12:00,3721,959,East,50,1863,809,Clothing,2762
13-06-2023 13:00,1364,1431,North,87,1546,205,Clothing,-67
13-06-2023 14:00,4925,2486,North,70,1955,374,Furniture,2439
13-06-2023 15:00,1820,824,North,83,1025,195,Electronics,996
13-06-2023 16:00,2402,1078,West,62,1105,781,Groceries,1324
13-06-2023 17:00,3390,2037,East,94,1866,129,Groceries,1353
13-06-2023 18:00,1946,2500,East,90,1378,893,Furniture,-554
13-06-2023 19:00,3946,2881,East,72,1575,998,Electronics,1065
13-06-2023 20:00,2577,2831,South,50,838,260,Clothing,-254
13-06-2023 21:00,2377,974,South,72,1564,405,Furniture,1403
13-06-2023 22:00,2439,1577,East,77,1017,722,Groceries,862
13-06-2023 23:00,4180,1981,North,81,906,823,Electronics,2199
14-06-2023 00:00,4634,2102,North,57,637,295,Clothing,2532
14-06-2023 01:00,1761,1943,East,75,1622,707,Clothing,-182
14-06-2023 02:00,4568,1131,West,63,840,437,Groceries,3437
14-06-2023 03:00,1340,1202,West,73,1839,237,Groceries,138
14-06-2023 04:00,3989,2956,North,97,1041,889,Groceries,1033
14-06-2023 05:00,1382,1481,North,78,724,546,Groceries,-99
14-06-2023 06:00,2003,1827,South,53,760,409,Clothing,176
14-06-2023 07:00,2556,2458,West,67,1770,278,Electronics,98
14-06-2023 08:00,1299,1058,North,63,1602,436,Clothing,241
14-06-2023 09:00,1138,721,North,76,1196,333,Groceries,417
14-06-2023 10:00,1358,2056,East,90,1310,348,Electronics,-698
14-06-2023 11:00,1835,2705,South,96,972,231,Clothing,-870
14-06-2023 12:00,2522,847,West,52,576,348,Electronics,1675
14-06-2023 13:00,4456,1682,West,79,761,904,Clothing,2774
14-06-2023 14:00,2627,1388,South,85,1525,554,Electronics,1239
14-06-2023 15:00,2982,1421,North,72,516,598,Clothing,1561
14-06-2023 16:00,2303,1758,West,67,843,162,Clothing,545
14-06-2023 17:00,4708,904,West,95,1535,918,Furniture,3804
14-06-2023 18:00,3530,1780,West,96,1439,491,Groceries,1750
14-06-2023 19:00,1908,1176,East,89,1193,356,Furniture,732
14-06-2023 20:00,2134,1088,South,59,1345,347,Clothing,1046
14-06-2023 21:00,3913,2120,West,61,1530,363,Groceries,1793
14-06-2023 22:00,3186,2094,South,90,745,566,Clothing,1092
14-06-2023 23:00,1995,1065,North,57,1485,948,Furniture,930
15-06-2023 00:00,3482,1203,South,81,1680,460,Electronics,2279
15-06-2023 01:00,3556,1357,East,66,673,979,Electronics,2199
15-06-2023 02:00,3320,1784,East,90,1345,492,Groceries,1536
15-06-2023 03:00,4170,1084,South,94,1192,278,Furniture,3086
15-06-2023 04:00,4835,731,East,63,1508,605,Furniture,4104
15-06-2023 05:00,4921,2817,West,86,780,926,Clothing,2104
15-06-2023 06:00,3151,1745,East,58,1832,912,Groceries,1406
15-06-2023 07:00,2237,551,North,75,1489,598,Electronics,1686
15-06-2023 08:00,2784,2663,South,97,736,776,Furniture,121
15-06-2023 09:00,4735,1037,South,73,656,702,Clothing,3698
15-06-2023 10:00,3809,1040,North,72,1774,933,Groceries,2769
15-06-2023 11:00,3834,1542,North,80,1522,803,Furniture,2292
15-06-2023 12:00,1164,1314,North,88,1744,391,Furniture,-150
15-06-2023 13:00,1998,1915,North,93,837,687,Electronics,83
15-06-2023 14:00,4924,2152,West,51,1746,917,Furniture,2772
15-06-2023 15:00,3567,918,East,99,1734,198,Electronics,2649
15-06-2023 16:00,2307,2856,East,67,836,706,Furniture,-549
15-06-2023 17:00,3564,1363,West,65,1657,280,Clothing,2201
15-06-2023 18:00,1656,685,North,78,1270,502,Clothing,971
15-06-2023 19:00,3660,760,South,60,994,765,Clothing,2900
15-06-2023 20:00,3211,2051,South,51,1046,473,Groceries,1160
15-06-2023 21:00,2909,1796,South,63,1706,967,Groceries,1113
15-06-2023 22:00,4730,2707,North,53,660,935,Clothing,2023
15-06-2023 23:00,3046,1261,West,88,1104,723,Clothing,1785
16-06-2023 00:00,3111,723,West,83,886,782,Clothing,2388
16-06-2023 01:00,4162,1779,West,95,1720,352,Electronics,2383
16-06-2023 02:00,2140,679,East,88,1487,994,Clothing,1461
16-06-2023 03:00,2889,2567,East,58,1875,962,Groceries,322
16-06-2023 04:00,1266,2147,East,89,733,221,Electronics,-881
16-06-2023 05:00,2845,1131,East,90,1932,541,Clothing,1714
16-06-2023 06:00,2708,2036,South,56,1799,816,Groceries,672
16-06-2023 07:00,4630,2605,South,66,1210,344,Electronics,2025
16-06-2023 08:00,4211,2463,West,72,958,738,Electronics,1748
16-06-2023 09:00,3293,1114,East,94,1976,590,Groceries,2179
16-06-2023 10:00,4732,1061,West,60,912,970,Groceries,3671
16-06-2023 11:00,4829,2921,North,71,1541,926,Electronics,1908
16-06-2023 12:00,3442,1121,East,67,571,145,Groceries,2321
16-06-2023 13:00,2510,2635,East,98,877,551,Electronics,-125
16-06-2023 14:00,1475,1513,West,77,1181,395,Electronics,-38
16-06-2023 15:00,4588,2561,West,65,1333,847,Electronics,2027
16-06-2023 16:00,1976,2680,North,91,1878,240,Electronics,-704
16-06-2023 17:00,2207,2460,West,53,650,732,Clothing,-253
16-06-2023 18:00,2043,1557,East,85,1784,972,Groceries,486
16-06-2023 19:00,2960,1091,South,71,1603,620,Clothing,1869
16-06-2023 20:00,1557,1082,North,60,1629,165,Clothing,475
16-06-2023 21:00,2017,2113,North,70,1926,582,Clothing,-96
16-06-2023 22:00,4595,1601,East,89,1219,408,Clothing,2994
16-06-2023 23:00,2605,788,South,90,629,559,Electronics,1817
17-06-2023 00:00,4600,2068,West,65,1694,692,Electronics,2532
17-06-2023 01:00,1882,1943,West,91,905,871,Electronics,-61
17-06-2023 02:00,3194,506,South,58,1556,993,Furniture,2688
17-06-2023 03:00,1665,1683,South,84,1035,497,Electronics,-18
17-06-2023 04:00,4375,739,East,83,696,568,Clothing,3636
17-06-2023 05:00,3667,2486,West,58,1416,716,Furniture,1181
17-06-2023 06:00,2771,1946,East,62,1569,491,Furniture,825
17-06-2023 07:00,3867,2249,West,55,773,196,Furniture,1618
17-06-2023 08:00,1863,2617,West,53,632,289,Electronics,-754
17-06-2023 09:00,1581,2403,South,95,763,959,Clothing,-822
17-06-2023 10:00,4070,2763,East,77,866,294,Electronics,1307
17-06-2023 11:00,1694,1577,South,60,1324,433,Groceries,117
17-06-2023 12:00,4833,2877,East,83,504,182,Furniture,1956
17-06-2023 13:00,2251,1347,West,84,768,350,Groceries,904
17-06-2023 14:00,4173,1811,North,54,1350,169,Furniture,2362
17-06-2023 15:00,2610,2592,North,88,1232,391,Furniture,18
17-06-2023 16:00,4488,2745,East,60,1944,439,Groceries,1743
17-06-2023 17:00,2239,1739,East,61,1869,484,Groceries,500
17-06-2023 18:00,3454,2004,South,92,568,799,Electronics,1450
17-06-2023 19:00,1398,1832,West,68,1299,557,Groceries,-434
17-06-2023 20:00,2946,2879,North,62,857,240,Groceries,67
17-06-2023 21:00,1714,1195,South,53,1909,239,Clothing,519
17-06-2023 22:00,1703,526,East,63,824,174,Groceries,1177
17-06-2023 23:00,3808,2865,West,93,1250,199,Electronics,943
18-06-2023 00:00,3546,2912,South,51,1702,756,Furniture,634
18-06-2023 01:00,4825,1459,South,57,755,274,Furniture,3366
18-06-2023 02:00,4536,2026,East,71,918,920,Clothing,2510
18-06-2023 03:00,2714,2368,West,62,710,832,Electronics,346
18-06-2023 04:00,2972,872,North,70,1410,422,Furniture,2100
18-06-2023 05:00,4021,2449,South,70,1083,576,Clothing,1572
18-06-2023 06:00,4802,744,East,77,1890,109,Furniture,4058
18-06-2023 07:00,1081,2340,South,82,1076,145,Electronics,-1259
18-06-2023 08:00,1603,2176,East,78,665,950,Groceries,-573
18-06-2023 09:00,2970,624,East,86,713,728,Clothing,2346
18-06-2023 10:00,2710,1036,East,71,1028,615,Groceries,1674
18-06-2023 11:00,3046,2419,West,75,1696,412,Electronics,627
18-06-2023 12:00,4822,2135,North,60,1652,337,Electronics,2687
18-06-2023 13:00,3819,1925,West,60,502,905,Furniture,1894
18-06-2023 14:00,1902,2040,North,94,1394,130,Furniture,-138
18-06-2023 15:00,1364,1030,East,83,1395,609,Clothing,334
18-06-2023 16:00,1162,753,North,68,1593,229,Furniture,409
18-06-2023 17:00,4119,2668,West,97,551,852,Furniture,1451
18-06-2023 18:00,3558,1160,South,86,936,484,Electronics,2398
18-06-2023 19:00,4400,2301,West,63,1901,692,Electronics,2099
18-06-2023 20:00,2863,1560,West,78,1521,124,Clothing,1303
18-06-2023 21:00,1115,1865,West,68,593,360,Groceries,-750
18-06-2023 22:00,3988,1536,West,86,1086,659,Clothing,2452
18-06-2023 23:00,4920,1706,West,70,1102,497,Electronics,3214
19-06-2023 00:00,3384,2635,North,73,585,663,Electronics,749
19-06-2023 01:00,1880,2593,North,75,1017,429,Clothing,-713
19-06-2023 02:00,3784,1642,South,90,1241,248,Clothing,2142
19-06-2023 03:00,4935,2054,West,61,929,508,Groceries,2881
19-06-2023 04:00,1839,2255,West,97,1362,710,Electronics,-416
19-06-2023 05:00,3194,2465,South,68,1328,678,Furniture,729
19-06-2023 06:00,4646,1244,South,96,542,821,Electronics,3402
19-06-2023 07:00,4877,2129,East,98,1893,859,Furniture,2748
19-06-2023 08:00,2346,1466,South,79,903,218,Furniture,880
19-06-2023 09:00,3490,1262,South,64,1826,533,Furniture,2228
19-06-2023 10:00,3884,1293,South,52,1705,327,Groceries,2591
19-06-2023 11:00,2036,1243,East,98,668,714,Clothing,793
19-06-2023 12:00,1942,1569,North,62,702,900,Furniture,373
19-06-2023 13:00,4565,2031,East,58,1205,339,Clothing,2534
19-06-2023 14:00,2724,1057,North,62,1042,331,Furniture,1667
19-06-2023 15:00,3334,2494,South,65,601,389,Groceries,840
19-06-2023 16:00,3767,1025,East,63,845,253,Furniture,2742
19-06-2023 17:00,2137,1339,East,57,1102,781,Clothing,798
19-06-2023 18:00,3527,502,North,68,941,258,Groceries,3025
19-06-2023 19:00,1021,1551,East,81,749,724,Clothing,-530
19-06-2023 20:00,4420,1904,East,84,1706,662,Clothing,2516
19-06-2023 21:00,2749,656,West,72,1825,575,Clothing,2093
19-06-2023 22:00,1682,2437,North,70,1377,647,Furniture,-755
19-06-2023 23:00,4906,2454,East,67,1803,112,Groceries,2452
20-06-2023 00:00,4637,1010,East,97,1612,952,Groceries,3627
20-06-2023 01:00,3953,1186,South,63,1948,606,Groceries,2767
20-06-2023 02:00,2833,1637,West,65,1808,317,Electronics,1196
20-06-2023 03:00,3367,1912,West,73,1170,854,Electronics,1455
20-06-2023 04:00,1125,2010,South,98,1653,834,Groceries,-885
20-06-2023 05:00,1276,1070,South,81,747,819,Furniture,206
20-06-2023 06:00,2999,1214,South,60,1151,880,Electronics,1785
20-06-2023 07:00,2227,1838,South,94,1400,321,Furniture,389
20-06-2023 08:00,3241,2786,West,60,1712,387,Furniture,455
20-06-2023 09:00,4752,2850,East,53,590,623,Electronics,1902
20-06-2023 10:00,4735,1490,East,75,1067,586,Clothing,3245
20-06-2023 11:00,4618,833,South,95,1688,798,Clothing,3785
20-06-2023 12:00,1695,2660,North,54,1047,780,Clothing,-965
20-06-2023 13:00,2309,2144,South,85,1853,904,Electronics,165
20-06-2023 14:00,1056,861,East,82,579,423,Furniture,195
20-06-2023 15:00,4805,2380,North,63,1433,717,Electronics,2425
20-06-2023 16:00,4374,2644,South,81,1480,275,Groceries,1730
20-06-2023 17:00,4234,2481,North,56,1369,960,Furniture,1753
20-06-2023 18:00,1018,2563,South,59,668,140,Electronics,-1545
20-06-2023 19:00,4441,2477,West,51,1616,923,Furniture,1964
20-06-2023 20:00,3311,875,East,59,1123,424,Electronics,2436
20-06-2023 21:00,3841,1241,South,84,878,860,Groceries,2600
20-06-2023 22:00,1112,889,North,70,1732,366,Groceries,223
20-06-2023 23:00,4559,1740,East,89,693,833,Groceries,2819
21-06-2023 00:00,4398,1323,South,91,763,492,Clothing,3075
21-06-2023 01:00,1541,2867,South,57,1770,212,Groceries,-1326
21-06-2023 02:00,3694,2743,South,95,1971,383,Clothing,951
21-06-2023 03:00,1578,917,South,67,1020,889,Furniture,661
21-06-2023 04:00,2088,1106,West,58,1418,302,Furniture,982
21-06-2023 05:00,4363,1067,East,90,978,952,Furniture,3296
21-06-2023 06:00,1024,1043,West,79,1800,873,Electronics,-19
21-06-2023 07:00,2572,2778,East,53,1652,893,Electronics,-206
21-06-2023 08:00,3048,1383,South,84,1825,243,Clothing,1665
21-06-2023 09:00,3958,1202,East,63,1073,342,Clothing,2756
21-06-2023 10:00,2572,1723,North,63,1883,881,Clothing,849
21-06-2023 11:00,1140,2122,East,97,1342,134,Electronics,-982
21-06-2023 12:00,2767,2568,North,86,1880,909,Electronics,199
21-06-2023 13:00,1647,2286,North,69,1989,152,Furniture,-639
21-06-2023 14:00,4972,2119,West,78,1695,602,Groceries,2853
21-06-2023 15:00,3235,1957,East,72,1611,455,Groceries,1278
21-06-2023 16:00,4199,2918,South,96,1395,249,Electronics,1281
21-06-2023 17:00,1200,2083,East,70,1606,536,Groceries,-883
21-06-2023 18:00,4198,2414,West,80,1016,549,Furniture,1784
21-06-2023 19:00,1256,577,North,81,1523,624,Groceries,679
21-06-2023 20:00,4747,1808,North,90,1395,366,Clothing,2939
21-06-2023 21:00,1546,1147,West,56,1845,708,Furniture,399
21-06-2023 22:00,3241,2687,West,62,964,185,Electronics,554
21-06-2023 23:00,3750,1052,East,72,1112,408,Clothing,2698
22-06-2023 00:00,4175,1497,North,57,1664,364,Electronics,2678
22-06-2023 01:00,4606,781,West,61,1104,591,Electronics,3825
22-06-2023 02:00,4336,1781,East,85,1120,682,Clothing,2555
22-06-2023 03:00,1801,2346,East,65,1499,116,Furniture,-545
22-06-2023 04:00,1941,1883,South,75,1054,288,Electronics,58
22-06-2023 05:00,4455,2987,North,78,635,621,Clothing,1468
22-06-2023 06:00,4331,2817,East,78,829,265,Clothing,1514
22-06-2023 07:00,1413,1657,West,55,1454,990,Electronics,-244
22-06-2023 08:00,3014,603,North,86,894,650,Electronics,2411
22-06-2023 09:00,2381,1265,West,82,655,977,Furniture,1116
22-06-2023 10:00,2098,2642,West,80,1562,444,Clothing,-544
22-06-2023 11:00,4426,2096,East,95,1805,318,Groceries,2330
22-06-2023 12:00,4655,979,East,90,1369,193,Groceries,3676
22-06-2023 13:00,4842,2560,South,67,1037,257,Electronics,2282
22-06-2023 14:00,1909,2463,West,87,1569,974,Electronics,-554
22-06-2023 15:00,1187,2642,East,96,1167,133,Furniture,-1455
22-06-2023 16:00,4756,2840,South,80,743,900,Groceries,1916
22-06-2023 17:00,3015,2572,North,65,1046,515,Electronics,443
22-06-2023 18:00,2313,1795,South,89,949,605,Electronics,518
22-06-2023 19:00,3092,2028,South,86,777,589,Groceries,1064
22-06-2023 20:00,4644,1689,West,63,1253,623,Electronics,2955
22-06-2023 21:00,3130,1438,North,88,905,332,Groceries,1692
22-06-2023 22:00,2146,1261,West,53,1270,698,Groceries,885
22-06-2023 23:00,1357,1153,West,79,1569,704,Furniture,204
23-06-2023 00:00,2551,2169,South,82,1248,206,Groceries,382
23-06-2023 01:00,2089,2431,South,85,1271,292,Electronics,-342
23-06-2023 02:00,3983,1626,East,79,1794,567,Clothing,2357
23-06-2023 03:00,2680,2425,South,63,737,621,Clothing,255
23-06-2023 04:00,3422,1074,East,72,1690,736,Clothing,2348
23-06-2023 05:00,1161,2841,West,97,1899,886,Furniture,-1680
23-06-2023 06:00,4817,1829,South,77,700,378,Electronics,2988
23-06-2023 07:00,4451,1777,North,56,1245,227,Furniture,2674
23-06-2023 08:00,4727,1703,North,91,731,440,Furniture,3024
23-06-2023 09:00,4429,539,West,59,1969,796,Furniture,3890
23-06-2023 10:00,4259,1019,West,53,1223,974,Electronics,3240
23-06-2023 11:00,3369,2139,South,93,1941,966,Electronics,1230
23-06-2023 12:00,1449,2783,East,87,1677,158,Electronics,-1334
23-06-2023 13:00,2497,962,South,62,1891,281,Clothing,1535
23-06-2023 14:00,2036,1751,East,70,1224,685,Groceries,285
23-06-2023 15:00,3231,2348,South,82,586,613,Electronics,883
23-06-2023 16:00,3158,982,North,89,1202,342,Electronics,2176
23-06-2023 17:00,2950,2977,North,77,1319,327,Furniture,-27
23-06-2023 18:00,3555,842,East,72,553,659,Electronics,2713
23-06-2023 19:00,2313,1696,South,81,1565,617,Groceries,617
23-06-2023 20:00,3342,1962,West,97,1872,654,Clothing,1380
23-06-2023 21:00,4522,1702,East,54,1753,244,Electronics,2820
23-06-2023 22:00,3951,2121,North,75,1241,226,Clothing,1830
23-06-2023 23:00,2238,2680,East,88,1193,434,Electronics,-442
24-06-2023 00:00,1973,2898,South,75,935,857,Clothing,-925
24-06-2023 01:00,1631,2631,West,52,1664,507,Electronics,-1000
24-06-2023 02:00,4965,1492,West,73,1811,220,Furniture,3473
24-06-2023 03:00,2590,2890,East,83,1845,843,Clothing,-300
24-06-2023 04:00,2050,1689,South,83,1093,987,Furniture,361
24-06-2023 05:00,4701,2840,South,69,941,800,Furniture,1861
24-06-2023 06:00,3780,2103,West,79,666,384,Electronics,1677
24-06-2023 07:00,4302,1693,North,91,1065,341,Furniture,2609
24-06-2023 08:00,2588,1097,South,69,1986,177,Furniture,1491
24-06-2023 09:00,4878,1144,West,90,1979,669,Electronics,3734
24-06-2023 10:00,3368,947,West,67,572,549,Furniture,2421
24-06-2023 11:00,3960,1263,South,87,1224,569,Clothing,2697
24-06-2023 12:00,4304,1234,South,69,1447,280,Clothing,3070
24-06-2023 13:00,2693,2142,East,55,769,681,Groceries,551
24-06-2023 14:00,1436,2797,North,91,718,364,Groceries,-1361
24-06-2023 15:00,3828,1100,East,74,1046,815,Groceries,2728
24-06-2023 16:00,2556,2672,East,90,1706,781,Groceries,-116
24-06-2023 17:00,4474,2660,West,90,1601,394,Furniture,1814
24-06-2023 18:00,2076,1480,West,52,807,989,Clothing,596
24-06-2023 19:00,4858,2282,North,93,1851,346,Groceries,2576
24-06-2023 20:00,4384,2697,East,92,920,523,Furniture,1687
24-06-2023 21:00,2304,2890,East,95,1759,158,Electronics,-586
24-06-2023 22:00,3773,1079,West,68,1348,911,Clothing,2694
24-06-2023 23:00,3078,1282,West,59,1385,932,Electronics,1796
25-06-2023 00:00,3384,2868,South,54,961,557,Groceries,516
25-06-2023 01:00,1182,1031,East,71,1084,110,Groceries,151
25-06-2023 02:00,4094,2012,North,58,1415,446,Groceries,2082
25-06-2023 03:00,3591,1111,East,82,537,951,Clothing,2480
25-06-2023 04:00,2469,2799,West,64,925,104,Electronics,-330
25-06-2023 05:00,4145,2505,South,73,933,816,Electronics,1640
25-06-2023 06:00,4081,1600,East,79,1882,469,Clothing,2481
25-06-2023 07:00,4555,2170,North,85,1554,557,Groceries,2385
25-06-2023 08:00,2479,1915,West,88,704,344,Groceries,564
25-06-2023 09:00,2589,1935,South,55,1204,348,Furniture,654
25-06-2023 10:00,2587,2720,East,64,1241,534,Clothing,-133
25-06-2023 11:00,1659,1374,North,87,1704,519,Electronics,285
25-06-2023 12:00,1159,2748,West,88,539,204,Furniture,-1589
25-06-2023 13:00,4953,716,North,71,1340,341,Electronics,4237
25-06-2023 14:00,4085,875,East,52,1946,371,Electronics,3210
25-06-2023 15:00,4249,2109,West,78,1405,618,Furniture,2140
25-06-2023 16:00,3459,510,East,78,1680,835,Electronics,2949
25-06-2023 17:00,4949,2113,South,80,667,828,Furniture,2836
25-06-2023 18:00,2011,2982,East,94,1141,143,Furniture,-971
25-06-2023 19:00,1052,1317,South,51,1605,125,Furniture,-265
25-06-2023 20:00,3455,1796,East,84,1186,903,Groceries,1659
25-06-2023 21:00,3894,1190,North,94,1099,280,Groceries,2704
25-06-2023 22:00,2045,2099,North,58,601,703,Clothing,-54
25-06-2023 23:00,2053,2032,West,71,1259,527,Clothing,21
26-06-2023 00:00,3750,1655,North,68,1217,367,Furniture,2095
26-06-2023 01:00,3307,2447,North,99,588,957,Clothing,860
26-06-2023 02:00,2228,1283,South,86,844,679,Groceries,945
26-06-2023 03:00,4130,2866,North,59,1299,975,Groceries,1264
26-06-2023 04:00,2494,2472,South,95,1833,250,Furniture,22
26-06-2023 05:00,3823,2376,South,70,1107,715,Groceries,1447
26-06-2023 06:00,2489,1284,South,66,1963,699,Furniture,1205
26-06-2023 07:00,2035,896,East,52,658,194,Clothing,1139
26-06-2023 08:00,4702,1581,South,56,1637,481,Groceries,3121
26-06-2023 09:00,2950,2003,East,90,1035,897,Furniture,947
26-06-2023 10:00,4361,2533,South,86,662,930,Furniture,1828
26-06-2023 11:00,1849,2114,East,85,785,614,Electronics,-265
26-06-2023 12:00,4831,959,West,52,1364,819,Furniture,3872
26-06-2023 13:00,1353,2608,West,62,554,713,Furniture,-1255
26-06-2023 14:00,4710,2916,East,90,1075,959,Groceries,1794
26-06-2023 15:00,2098,1045,West,79,532,788,Electronics,1053
26-06-2023 16:00,3920,996,North,72,1057,527,Electronics,2924
26-06-2023 17:00,2739,1004,South,56,1230,524,Electronics,1735
26-06-2023 18:00,4632,1592,East,79,1492,915,Groceries,3040
26-06-2023 19:00,4662,2708,West,78,1300,298,Clothing,1954
26-06-2023 20:00,2464,2137,West,57,695,107,Furniture,327
26-06-2023 21:00,1990,1217,North,59,947,856,Electronics,773
26-06-2023 22:00,2264,2092,South,82,1424,904,Electronics,172
26-06-2023 23:00,4065,1908,North,69,591,426,Groceries,2157
27-06-2023 00:00,2884,768,East,78,1107,789,Groceries,2116
27-06-2023 01:00,4225,2446,West,78,1751,693,Electronics,1779
27-06-2023 02:00,2809,1977,West,70,785,723,Clothing,832
27-06-2023 03:00,4167,2041,West,50,1373,970,Groceries,2126
27-06-2023 04:00,4797,1364,North,83,1758,120,Electronics,3433
27-06-2023 05:00,3341,2897,North,93,601,645,Clothing,444
27-06-2023 06:00,3256,609,South,81,639,354,Groceries,2647
27-06-2023 07:00,4414,2954,East,94,1334,532,Clothing,1460
27-06-2023 08:00,2111,1149,South,63,765,604,Electronics,962
27-06-2023 09:00,1817,2598,South,86,1865,126,Clothing,-781
27-06-2023 10:00,2799,1999,West,84,1072,619,Electronics,800
27-06-2023 11:00,2960,1610,North,73,1034,629,Groceries,1350
27-06-2023 12:00,3437,1095,East,98,1022,599,Furniture,2342
27-06-2023 13:00,3372,1478,South,50,515,332,Furniture,1894
27-06-2023 14:00,3987,1230,East,95,1060,495,Electronics,2757
27-06-2023 15:00,1888,556,West,55,1377,406,Furniture,1332
27-06-2023 16:00,2855,2743,South,98,835,609,Electronics,112
27-06-2023 17:00,2180,2283,North,53,1409,802,Furniture,-103
27-06-2023 18:00,1667,2201,South,87,1913,523,Furniture,-534
27-06-2023 19:00,4722,1786,West,50,669,249,Groceries,2936
27-06-2023 20:00,1632,611,South,90,1412,491,Electronics,1021
27-06-2023 21:00,3624,1210,West,80,618,589,Clothing,2414
27-06-2023 22:00,2642,1701,South,85,1565,767,Groceries,941
27-06-2023 23:00,4730,1447,East,58,1512,146,Clothing,3283
28-06-2023 00:00,1136,525,North,90,509,411,Groceries,611
28-06-2023 01:00,2946,2957,West,94,929,238,Electronics,-11
28-06-2023 02:00,2697,1257,East,72,1991,504,Clothing,1440
28-06-2023 03:00,1427,2300,West,80,548,753,Groceries,-873
28-06-2023 04:00,2475,2055,South,78,706,946,Furniture,420
28-06-2023 05:00,3659,2341,West,98,1013,113,Clothing,1318
28-06-2023 06:00,4921,2793,West,70,1733,967,Groceries,2128
28-06-2023 07:00,3958,1604,North,52,1662,870,Groceries,2354
28-06-2023 08:00,1818,1161,East,75,536,847,Clothing,657
28-06-2023 09:00,3188,1408,South,55,717,989,Furniture,1780
28-06-2023 10:00,2106,2943,North,69,1979,618,Clothing,-837
28-06-2023 11:00,3224,1021,West,96,1801,650,Clothing,2203
28-06-2023 12:00,1197,2356,North,95,679,284,Clothing,-1159
28-06-2023 13:00,3671,2259,West,62,629,214,Groceries,1412
28-06-2023 14:00,4639,2811,South,90,1110,209,Furniture,1828
28-06-2023 15:00,2995,1289,West,72,1158,676,Clothing,1706
28-06-2023 16:00,3738,1797,North,64,858,842,Clothing,1941
28-06-2023 17:00,4492,2229,North,95,1126,380,Clothing,2263
28-06-2023 18:00,3448,671,West,80,1527,642,Clothing,2777
28-06-2023 19:00,4769,764,East,53,1606,185,Clothing,4005
28-06-2023 20:00,1470,2486,North,60,1677,237,Clothing,-1016
28-06-2023 21:00,3265,1549,East,51,1005,565,Furniture,1716
28-06-2023 22:00,2948,1992,East,65,1317,176,Furniture,956
28-06-2023 23:00,1928,2385,East,80,1293,236,Furniture,-457
29-06-2023 00:00,4899,975,East,97,1338,733,Electronics,3924
29-06-2023 01:00,3010,2903,North,88,1122,875,Electronics,107
29-06-2023 02:00,4800,1549,North,92,1128,196,Groceries,3251
29-06-2023 03:00,3679,533,East,93,596,630,Furniture,3146
29-06-2023 04:00,3998,2811,North,53,1805,897,Furniture,1187
29-06-2023 05:00,1905,1661,East,97,1318,108,Furniture,244
29-06-2023 06:00,3222,1315,East,77,1098,182,Clothing,1907
29-06-2023 07:00,1022,1253,East,65,1433,146,Clothing,-231
29-06-2023 08:00,4796,1065,West,88,928,611,Groceries,3731
29-06-2023 09:00,4988,961,South,74,1649,529,Furniture,4027
29-06-2023 10:00,1234,2154,North,62,1824,189,Clothing,-920
29-06-2023 11:00,4084,580,North,54,1042,612,Furniture,3504
29-06-2023 12:00,2124,2437,East,79,866,998,Furniture,-313
29-06-2023 13:00,1928,1369,West,50,1568,773,Clothing,559
29-06-2023 14:00,4607,1930,West,54,1839,764,Clothing,2677
29-06-2023 15:00,4947,1569,North,63,1712,513,Electronics,3378
29-06-2023 16:00,1522,1098,East,60,551,612,Clothing,424
29-06-2023 17:00,2808,2134,North,83,1063,990,Electronics,674
29-06-2023 18:00,4523,1306,East,78,1855,757,Clothing,3217
29-06-2023 19:00,1430,2434,East,67,998,772,Furniture,-1004
29-06-2023 20:00,1792,1576,South,64,1476,746,Clothing,216
29-06-2023 21:00,2629,1203,East,95,1841,897,Groceries,1426
29-06-2023 22:00,2736,2563,South,74,1933,176,Furniture,173
29-06-2023 23:00,1532,986,North,79,822,180,Groceries,546
30-06-2023 00:00,4923,1205,North,94,1753,880,Furniture,3718
30-06-2023 01:00,4026,2025,West,51,1867,880,Clothing,2001
30-06-2023 02:00,2746,1664,South,89,1894,653,Clothing,1082
30-06-2023 03:00,2675,1119,North,76,1055,735,Clothing,1556
30-06-2023 04:00,2316,1276,South,98,1815,841,Electronics,1040
30-06-2023 05:00,3857,946,North,64,1960,968,Clothing,2911
30-06-2023 06:00,1912,2837,South,81,1770,301,Groceries,-925
30-06-2023 07:00,2124,708,South,69,718,945,Electronics,1416
30-06-2023 08:00,2525,1998,East,63,1033,546,Clothing,527
30-06-2023 09:00,2327,2960,North,76,1141,206,Electronics,-633
30-06-2023 10:00,3918,1950,West,52,1018,391,Electronics,1968
30-06-2023 11:00,3587,2377,East,98,1995,902,Furniture,1210
30-06-2023 12:00,2023,2837,West,52,1873,785,Electronics,-814
30-06-2023 13:00,2576,1791,South,62,543,411,Electronics,785
30-06-2023 14:00,2378,2698,East,74,564,698,Furniture,-320
30-06-2023 15:00,4374,2242,South,67,745,616,Clothing,2132
30-06-2023 16:00,2519,1778,North,50,1486,783,Groceries,741
30-06-2023 17:00,2681,1900,North,88,1594,732,Electronics,781
30-06-2023 18:00,4839,2176,West,54,657,767,Groceries,2663
30-06-2023 19:00,2997,1354,North,51,1437,698,Electronics,1643
30-06-2023 20:00,1226,1881,West,79,1998,525,Groceries,-655
30-06-2023 21:00,2259,2917,South,66,1548,709,Furniture,-658
30-06-2023 22:00,1872,1204,East,78,1324,514,Electronics,668
30-06-2023 23:00,1891,1325,North,91,1746,234,Electronics,566
01-07-2023 00:00,2478,1504,South,53,659,618,Clothing,974
01-07-2023 01:00,2036,876,East,58,1317,871,Clothing,1160
01-07-2023 02:00,3257,1472,South,70,1504,463,Electronics,1785
01-07-2023 03:00,3788,617,West,92,574,483,Furniture,3171
01-07-2023 04:00,1396,943,South,61,637,131,Groceries,453
01-07-2023 05:00,2123,1254,West,61,978,639,Clothing,869
01-07-2023 06:00,3078,1139,West,99,1052,871,Clothing,1939
01-07-2023 07:00,3945,2671,North,53,1826,586,Clothing,1274
01-07-2023 08:00,4599,1800,West,77,886,855,Clothing,2799
01-07-2023 09:00,1648,2907,West,58,971,464,Furniture,-1259
01-07-2023 10:00,1328,1122,South,89,1857,363,Electronics,206
01-07-2023 11:00,4237,1992,West,81,808,241,Groceries,2245
01-07-2023 12:00,2482,2508,West,62,1386,129,Clothing,-26
01-07-2023 13:00,4893,2151,South,83,1200,998,Furniture,2742
01-07-2023 14:00,1951,2223,East,68,1686,229,Furniture,-272
01-07-2023 15:00,3005,2419,North,63,1499,877,Clothing,586
01-07-2023 16:00,3016,1418,South,54,1451,169,Groceries,1598
01-07-2023 17:00,4171,1673,West,76,1578,218,Clothing,2498
01-07-2023 18:00,3668,2999,South,77,1285,426,Furniture,669
01-07-2023 19:00,2878,1685,East,75,1978,169,Groceries,1193
01-07-2023 20:00,2196,619,South,59,804,307,Furniture,1577
01-07-2023 21:00,2772,1081,South,73,601,190,Electronics,1691
01-07-2023 22:00,1161,2447,South,66,1274,219,Furniture,-1286
01-07-2023 23:00,4976,2646,South,65,1911,306,Clothing,2330
02-07-2023 00:00,2751,1690,West,66,1731,505,Groceries,1061
02-07-2023 01:00,1775,2186,South,50,1838,867,Clothing,-411
02-07-2023 02:00,4334,2499,East,70,1572,646,Electronics,1835
02-07-2023 03:00,2827,900,South,96,1071,223,Groceries,1927
02-07-2023 04:00,3321,2912,South,98,647,211,Groceries,409
02-07-2023 05:00,4074,1849,West,92,1734,306,Groceries,2225
02-07-2023 06:00,2051,2156,West,71,1895,713,Furniture,-105
02-07-2023 07:00,3373,1120,South,54,1096,485,Clothing,2253
02-07-2023 08:00,1939,746,West,85,1477,805,Groceries,1193
02-07-2023 09:00,4220,2981,West,70,1570,852,Groceries,1239
02-07-2023 10:00,1539,1616,South,58,998,246,Groceries,-77
02-07-2023 11:00,3535,1123,West,76,654,231,Electronics,2412
02-07-2023 12:00,1821,2868,North,97,729,831,Groceries,-1047
02-07-2023 13:00,2461,2339,North,61,1823,949,Furniture,122
02-07-2023 14:00,2088,2609,North,67,657,203,Furniture,-521
02-07-2023 15:00,1355,799,West,84,1422,652,Groceries,556
02-07-2023 16:00,4604,902,North,64,1770,667,Furniture,3702
02-07-2023 17:00,4323,2171,East,99,1067,922,Furniture,2152
02-07-2023 18:00,1234,752,North,93,1674,861,Groceries,482
02-07-2023 19:00,3274,2257,East,79,798,341,Furniture,1017
02-07-2023 20:00,2548,1892,West,94,1577,738,Electronics,656
02-07-2023 21:00,4384,2464,North,82,1746,761,Groceries,1920
02-07-2023 22:00,3096,659,East,85,1265,430,Clothing,2437
02-07-2023 23:00,1117,704,West,89,1064,947,Furniture,413
03-07-2023 00:00,3101,1661,North,79,966,995,Groceries,1440
03-07-2023 01:00,2673,1891,South,75,985,999,Clothing,782
03-07-2023 02:00,3612,1357,North,70,943,248,Electronics,2255
03-07-2023 03:00,2067,1259,North,86,1404,268,Electronics,808
03-07-2023 04:00,4886,2090,North,92,1362,656,Groceries,2796
03-07-2023 05:00,3100,2615,South,80,1661,183,Groceries,485
03-07-2023 06:00,4657,632,East,66,1425,619,Electronics,4025
03-07-2023 07:00,1557,2223,East,66,791,206,Electronics,-666
03-07-2023 08:00,4596,929,South,83,1733,984,Electronics,3667
03-07-2023 09:00,4748,2855,North,73,1251,364,Clothing,1893
03-07-2023 10:00,4173,1697,North,82,1734,757,Clothing,2476
03-07-2023 11:00,2815,2959,North,53,1374,130,Groceries,-144
03-07-2023 12:00,4841,596,East,58,1162,855,Clothing,4245
03-07-2023 13:00,3005,2206,East,51,1911,646,Furniture,799
03-07-2023 14:00,4920,1677,South,84,1919,346,Electronics,3243
03-07-2023 15:00,3915,2218,West,87,1647,629,Groceries,1697
03-07-2023 16:00,1397,1765,South,94,1419,123,Clothing,-368
03-07-2023 17:00,4209,1827,East,64,1408,597,Groceries,2382
03-07-2023 18:00,1674,1808,North,92,623,953,Clothing,-134
03-07-2023 19:00,4992,1550,North,91,567,403,Groceries,3442
03-07-2023 20:00,1386,1883,North,52,974,497,Electronics,-497
03-07-2023 21:00,3158,2749,North,80,857,502,Electronics,409
03-07-2023 22:00,3661,1080,West,90,1979,415,Electronics,2581
03-07-2023 23:00,3064,2917,South,91,1869,960,Clothing,147
04-07-2023 00:00,4851,1032,South,72,1020,377,Groceries,3819
04-07-2023 01:00,4253,1675,East,61,1332,641,Groceries,2578
04-07-2023 02:00,1883,1625,South,57,1123,242,Groceries,258
04-07-2023 03:00,4607,1398,West,70,1851,888,Furniture,3209
04-07-2023 04:00,1540,1969,West,70,1853,509,Clothing,-429
04-07-2023 05:00,1170,1752,West,81,926,455,Electronics,-582
04-07-2023 06:00,3456,1269,North,66,1508,623,Electronics,2187
04-07-2023 07:00,1739,1333,East,86,942,302,Groceries,406
04-07-2023 08:00,2401,2404,West,73,1100,349,Groceries,-3
04-07-2023 09:00,4259,2783,South,57,1618,202,Furniture,1476
04-07-2023 10:00,3905,2709,South,67,1261,567,Clothing,1196
04-07-2023 11:00,3277,1053,South,60,1454,134,Groceries,2224
04-07-2023 12:00,4904,1591,West,59,1974,423,Groceries,3313
04-07-2023 13:00,4923,1696,West,75,1840,997,Clothing,3227
04-07-2023 14:00,1118,2160,South,96,986,631,Groceries,-1042
04-07-2023 15:00,4227,1058,West,55,1238,658,Electronics,3169
04-07-2023 16:00,3831,760,South,66,1147,695,Clothing,3071
04-07-2023 17:00,4758,2764,North,72,1395,367,Electronics,1994
04-07-2023 18:00,3512,2340,West,91,504,152,Furniture,1172
04-07-2023 19:00,3151,1647,North,86,1131,884,Groceries,1504
04-07-2023 20:00,4675,1304,North,77,1894,117,Groceries,3371
04-07-2023 21:00,3745,1685,West,65,1376,203,Clothing,2060
04-07-2023 22:00,2995,2748,South,61,1485,251,Furniture,247
04-07-2023 23:00,4866,2949,East,70,1711,939,Clothing,1917
05-07-2023 00:00,4573,774,North,73,525,776,Furniture,3799
05-07-2023 01:00,4764,705,West,77,661,972,Clothing,4059
05-07-2023 02:00,2705,2223,North,86,1244,513,Clothing,482
05-07-2023 03:00,2722,1366,South,70,1653,183,Groceries,1356
05-07-2023 04:00,3222,592,West,82,1032,407,Groceries,2630
05-07-2023 05:00,4805,1565,East,51,1382,250,Furniture,3240
05-07-2023 06:00,3792,2926,West,86,909,648,Electronics,866
05-07-2023 07:00,2697,1851,North,68,1596,478,Electronics,846
05-07-2023 08:00,2444,2612,West,77,1756,557,Clothing,-168
05-07-2023 09:00,4205,864,West,64,1354,452,Groceries,3341
05-07-2023 10:00,4462,1320,North,50,1629,763,Clothing,3142
05-07-2023 11:00,2759,2007,East,92,1400,967,Furniture,752
05-07-2023 12:00,2524,2529,South,77,508,475,Clothing,-5
05-07-2023 13:00,1664,2424,West,99,549,307,Clothing,-760
05-07-2023 14:00,1032,1585,East,84,941,661,Clothing,-553
05-07-2023 15:00,3102,1796,South,81,535,831,Furniture,1306
05-07-2023 16:00,3566,2776,North,77,1725,559,Furniture,790
05-07-2023 17:00,3803,1543,East,58,617,503,Clothing,2260
05-07-2023 18:00,4896,502,East,73,1201,658,Groceries,4394
05-07-2023 19:00,4709,2253,West,53,1253,629,Furniture,2456
05-07-2023 20:00,3059,1410,North,94,1692,584,Electronics,1649
05-07-2023 21:00,2551,806,West,90,729,221,Clothing,1745
05-07-2023 22:00,1719,2979,North,52,1059,893,Groceries,-1260
05-07-2023 23:00,3602,635,South,97,1673,219,Furniture,2967
06-07-2023 00:00,3420,2432,West,71,707,350,Clothing,988
06-07-2023 01:00,1483,2740,North,89,1584,938,Groceries,-1257
06-07-2023 02:00,1972,2108,North,88,1640,398,Electronics,-136
06-07-2023 03:00,4718,1938,East,98,738,146,Furniture,2780
06-07-2023 04:00,4299,1372,West,74,1366,696,Furniture,2927
06-07-2023 05:00,3670,1641,West,97,547,398,Electronics,2029
06-07-2023 06:00,1306,1165,South,71,1971,995,Furniture,141
06-07-2023 07:00,1456,708,North,99,1256,771,Groceries,748
06-07-2023 08:00,3207,1451,East,97,1991,618,Furniture,1756
06-07-2023 09:00,1330,1557,North,96,1816,344,Clothing,-227
06-07-2023 10:00,3823,1148,North,83,1948,826,Electronics,2675
06-07-2023 11:00,1224,1841,North,69,1016,823,Clothing,-617
06-07-2023 12:00,4030,2667,West,85,704,823,Furniture,1363
06-07-2023 13:00,3776,1126,North,86,1703,899,Clothing,2650
06-07-2023 14:00,4575,1024,South,88,589,317,Groceries,3551
06-07-2023 15:00,2479,2104,East,76,999,862,Clothing,375
06-07-2023 16:00,4116,2368,East,96,1631,443,Groceries,1748
06-07-2023 17:00,4285,1268,North,98,1713,932,Groceries,3017
06-07-2023 18:00,2082,2594,East,81,1703,413,Groceries,-512
06-07-2023 19:00,1643,1271,North,91,1543,792,Electronics,372
06-07-2023 20:00,1615,1239,West,78,1882,703,Clothing,376
06-07-2023 21:00,1194,1021,East,90,506,829,Groceries,173
06-07-2023 22:00,4996,1900,West,97,821,389,Groceries,3096
06-07-2023 23:00,1488,2681,West,81,767,701,Clothing,-1193
07-07-2023 00:00,3204,747,South,73,1950,296,Furniture,2457
07-07-2023 01:00,3657,1841,South,52,795,795,Electronics,1816
07-07-2023 02:00,2249,2983,East,76,1069,677,Groceries,-734
07-07-2023 03:00,3459,2358,North,58,1910,515,Furniture,1101
07-07-2023 04:00,4276,1185,North,89,763,709,Furniture,3091
07-07-2023 05:00,2102,1085,North,72,589,405,Furniture,1017
07-07-2023 06:00,2147,2898,North,56,1352,577,Groceries,-751
07-07-2023 07:00,3518,642,South,66,1784,635,Groceries,2876
07-07-2023 08:00,2241,1466,North,86,987,319,Groceries,775
07-07-2023 09:00,1515,1217,North,56,1864,785,Clothing,298
07-07-2023 10:00,2625,1142,West,79,1852,998,Groceries,1483
07-07-2023 11:00,2127,869,North,62,900,856,Electronics,1258
07-07-2023 12:00,1392,1609,North,67,856,725,Clothing,-217
07-07-2023 13:00,1630,1286,South,80,1254,877,Electronics,344
07-07-2023 14:00,4716,1983,East,71,998,453,Furniture,2733
07-07-2023 15:00,2847,1449,West,63,1333,834,Clothing,1398
07-07-2023 16:00,3655,1848,West,67,934,919,Clothing,1807
07-07-2023 17:00,1979,1021,East,84,618,334,Clothing,958
07-07-2023 18:00,1433,2452,West,66,1570,405,Electronics,-1019
07-07-2023 19:00,4402,2944,North,68,1691,209,Electronics,1458
07-07-2023 20:00,4214,854,North,80,1522,413,Furniture,3360
07-07-2023 21:00,4871,1446,East,88,847,112,Groceries,3425
07-07-2023 22:00,3587,2835,South,85,1038,736,Electronics,752
07-07-2023 23:00,1277,1982,South,64,1819,926,Furniture,-705
08-07-2023 00:00,1232,2147,West,78,1697,266,Groceries,-915
08-07-2023 01:00,2552,1035,South,89,1918,152,Clothing,1517
08-07-2023 02:00,2594,1814,South,65,1029,285,Groceries,780
08-07-2023 03:00,2113,2715,South,82,802,375,Electronics,-602
08-07-2023 04:00,4563,1449,South,74,701,546,Furniture,3114
08-07-2023 05:00,4270,1120,South,65,655,451,Clothing,3150
08-07-2023 06:00,3409,927,South,79,513,109,Clothing,2482
08-07-2023 07:00,4512,2225,South,83,1543,509,Groceries,2287
08-07-2023 08:00,1025,2902,West,51,1255,246,Groceries,-1877
08-07-2023 09:00,4096,2743,North,89,1388,576,Electronics,1353
08-07-2023 10:00,2417,1044,South,93,1980,928,Clothing,1373
08-07-2023 11:00,3554,1323,North,92,1696,944,Groceries,2231
08-07-2023 12:00,4372,1502,East,87,944,729,Clothing,2870
08-07-2023 13:00,4410,1158,North,67,621,951,Furniture,3252
08-07-2023 14:00,3314,2558,East,54,683,527,Furniture,756
08-07-2023 15:00,1460,2943,West,96,1170,587,Electronics,-1483
08-07-2023 16:00,4764,1230,North,89,548,629,Clothing,3534
08-07-2023 17:00,3503,2332,East,55,680,476,Groceries,1171
08-07-2023 18:00,4431,908,North,61,1917,837,Furniture,3523
08-07-2023 19:00,2091,2909,West,61,1916,211,Furniture,-818
08-07-2023 20:00,2006,583,North,61,1871,683,Electronics,1423
08-07-2023 21:00,3910,2703,East,58,1999,755,Furniture,1207
08-07-2023 22:00,4483,1206,South,91,640,715,Electronics,3277
08-07-2023 23:00,2994,2461,South,71,1029,314,Clothing,533
09-07-2023 00:00,1490,1947,South,98,1083,609,Groceries,-457
09-07-2023 01:00,4904,633,West,99,970,610,Clothing,4271
09-07-2023 02:00,2072,1287,South,65,1786,688,Clothing,785
09-07-2023 03:00,4758,1363,West,53,642,125,Clothing,3395
09-07-2023 04:00,3611,1166,South,99,1206,841,Groceries,2445
09-07-2023 05:00,4173,776,West,52,1669,292,Clothing,3397
09-07-2023 06:00,1215,2275,West,65,793,202,Clothing,-1060
09-07-2023 07:00,4509,1381,North,63,921,304,Electronics,3128
09-07-2023 08:00,2723,2560,South,90,1063,510,Electronics,163
09-07-2023 09:00,2592,2889,North,87,916,871,Electronics,-297
09-07-2023 10:00,3606,2582,East,53,1160,844,Groceries,1024
09-07-2023 11:00,1158,1737,South,51,1412,150,Furniture,-579
09-07-2023 12:00,3536,2952,South,59,1630,230,Furniture,584
09-07-2023 13:00,1685,658,South,60,1841,442,Clothing,1027
09-07-2023 14:00,4313,1633,South,88,558,677,Furniture,2680
09-07-2023 15:00,3841,2351,North,75,1515,499,Clothing,1490
09-07-2023 16:00,2776,778,North,86,757,301,Electronics,1998
09-07-2023 17:00,4953,610,West,75,1292,895,Clothing,4343
09-07-2023 18:00,3052,2978,North,53,1948,399,Groceries,74
09-07-2023 19:00,4667,1041,West,75,1030,245,Furniture,3626
09-07-2023 20:00,2843,1638,East,87,665,869,Clothing,1205
09-07-2023 21:00,3408,859,North,77,1548,561,Electronics,2549
09-07-2023 22:00,3506,2919,West,51,503,923,Groceries,587
09-07-2023 23:00,3295,1738,South,51,502,603,Clothing,1557
10-07-2023 00:00,2589,2256,East,65,917,987,Clothing,333
10-07-2023 01:00,2696,1454,West,72,861,715,Clothing,1242
10-07-2023 02:00,3993,2806,East,72,1405,250,Groceries,1187
10-07-2023 03:00,3469,2667,South,62,868,729,Clothing,802
10-07-2023 04:00,2946,1475,South,70,1038,415,Electronics,1471
10-07-2023 05:00,4809,1412,West,88,1379,298,Electronics,3397
10-07-2023 06:00,3062,1651,West,74,845,528,Electronics,1411
10-07-2023 07:00,3783,1222,South,86,1230,402,Electronics,2561
10-07-2023 08:00,4644,2211,West,98,1396,945,Groceries,2433
10-07-2023 09:00,2145,824,South,62,1567,597,Electronics,1321
10-07-2023 10:00,3324,2029,North,64,1223,890,Electronics,1295
10-07-2023 11:00,2581,2049,West,77,1063,204,Furniture,532
10-07-2023 12:00,3500,1573,East,52,1676,109,Electronics,1927
10-07-2023 13:00,4461,2445,South,72,701,724,Groceries,2016
10-07-2023 14:00,4365,2107,North,53,820,126,Furniture,2258
10-07-2023 15:00,4645,2616,West,96,963,710,Furniture,2029
10-07-2023 16:00,3645,890,South,99,1534,868,Groceries,2755
10-07-2023 17:00,3493,2930,North,52,1750,426,Furniture,563
10-07-2023 18:00,3257,515,West,88,1132,594,Clothing,2742
10-07-2023 19:00,4661,1345,South,57,832,982,Electronics,3316
10-07-2023 20:00,3761,1368,South,92,1992,747,Clothing,2393
10-07-2023 21:00,3349,1067,South,74,514,837,Groceries,2282
10-07-2023 22:00,2932,2679,West,90,1580,226,Clothing,253
10-07-2023 23:00,4294,2519,North,61,1853,215,Groceries,1775
11-07-2023 00:00,2757,2820,South,54,1587,901,Clothing,-63
11-07-2023 01:00,3050,2146,North,82,729,270,Electronics,904
11-07-2023 02:00,1989,856,North,95,510,311,Groceries,1133
11-07-2023 03:00,2541,2156,East,74,1747,288,Groceries,385
11-07-2023 04:00,2116,2780,North,74,1041,589,Groceries,-664
11-07-2023 05:00,3567,535,North,84,1021,486,Furniture,3032
11-07-2023 06:00,4499,2960,North,64,1577,876,Electronics,1539
11-07-2023 07:00,1492,1527,North,91,1266,825,Furniture,-35
11-07-2023 08:00,4306,2591,North,75,1680,700,Furniture,1715
11-07-2023 09:00,1619,613,West,59,1140,229,Electronics,1006
11-07-2023 10:00,4232,2272,East,73,1069,122,Groceries,1960
11-07-2023 11:00,4792,2944,South,84,904,278,Furniture,1848
11-07-2023 12:00,4823,1697,East,78,1922,500,Furniture,3126
11-07-2023 13:00,3378,1778,East,87,1206,604,Groceries,1600
11-07-2023 14:00,3380,965,South,54,1428,510,Electronics,2415
11-07-2023 15:00,3097,1987,North,73,1926,631,Electronics,1110
11-07-2023 16:00,2546,1346,South,68,1612,428,Electronics,1200
11-07-2023 17:00,1862,1001,North,95,1092,570,Furniture,861
11-07-2023 18:00,2691,940,South,98,685,519,Electronics,1751
11-07-2023 19:00,4563,2616,West,93,1394,511,Electronics,1947
11-07-2023 20:00,2605,825,East,58,578,853,Furniture,1780
11-07-2023 21:00,4752,2265,North,75,644,851,Electronics,2487
11-07-2023 22:00,3319,566,East,74,513,128,Clothing,2753
11-07-2023 23:00,1579,803,North,84,501,344,Electronics,776
12-07-2023 00:00,2890,1471,South,99,1015,731,Electronics,1419
12-07-2023 01:00,2275,983,South,85,1255,925,Groceries,1292
12-07-2023 02:00,3607,1428,South,63,565,985,Furniture,2179
12-07-2023 03:00,3743,1940,West,55,745,643,Groceries,1803
12-07-2023 04:00,2855,648,South,81,1953,751,Clothing,2207
12-07-2023 05:00,4770,2795,South,75,1071,769,Electronics,1975
12-07-2023 06:00,4161,1624,West,64,1755,159,Groceries,2537
12-07-2023 07:00,3493,595,East,98,935,238,Groceries,2898
12-07-2023 08:00,4064,781,East,80,852,456,Clothing,3283
12-07-2023 09:00,2355,2869,North,86,1178,311,Electronics,-514
12-07-2023 10:00,2162,1028,East,87,882,238,Groceries,1134
12-07-2023 11:00,1356,2810,North,86,1583,467,Electronics,-1454
12-07-2023 12:00,2624,2142,North,68,969,722,Clothing,482
12-07-2023 13:00,3321,1079,East,63,1934,585,Clothing,2242
12-07-2023 14:00,4090,2163,East,85,1606,592,Electronics,1927
12-07-2023 15:00,3006,2841,West,86,573,435,Clothing,165
12-07-2023 16:00,3358,2131,North,60,1834,862,Furniture,1227
12-07-2023 17:00,1869,2942,East,76,1977,710,Groceries,-1073
12-07-2023 18:00,1885,1309,East,51,525,277,Furniture,576
12-07-2023 19:00,3001,1192,West,71,1949,612,Furniture,1809
12-07-2023 20:00,3201,734,East,51,1900,700,Clothing,2467
12-07-2023 21:00,2413,1451,South,69,1766,212,Clothing,962
12-07-2023 22:00,2283,2354,South,93,1334,382,Electronics,-71
12-07-2023 23:00,1619,1860,North,97,1127,215,Furniture,-241
13-07-2023 00:00,1882,1531,West,66,1846,643,Groceries,351
13-07-2023 01:00,1796,1966,East,53,1703,873,Electronics,-170
13-07-2023 02:00,4642,2464,North,63,1273,140,Electronics,2178
13-07-2023 03:00,3172,1038,East,56,1508,266,Electronics,2134
13-07-2023 04:00,4425,1319,South,64,765,954,Clothing,3106
13-07-2023 05:00,2296,2181,East,79,1049,320,Clothing,115
13-07-2023 06:00,1618,771,East,65,1903,825,Electronics,847
13-07-2023 07:00,2834,1528,East,89,576,412,Clothing,1306
13-07-2023 08:00,1244,2422,South,51,1572,445,Clothing,-1178
13-07-2023 09:00,3895,1742,South,68,1513,570,Electronics,2153
13-07-2023 10:00,3497,1641,West,50,1777,230,Groceries,1856
13-07-2023 11:00,1929,1092,South,80,1903,147,Groceries,837
13-07-2023 12:00,2270,2105,North,53,1772,233,Clothing,165
13-07-2023 13:00,1519,614,East,76,1595,618,Groceries,905
13-07-2023 14:00,4212,2810,South,74,946,655,Groceries,1402
13-07-2023 15:00,3409,2177,North,71,1005,416,Clothing,1232
13-07-2023 16:00,1007,1945,South,92,1776,537,Groceries,-938
13-07-2023 17:00,3525,706,East,59,1495,534,Clothing,2819
13-07-2023 18:00,4423,2850,North,99,1369,185,Furniture,1573
13-07-2023 19:00,3019,611,South,82,798,147,Electronics,2408
13-07-2023 20:00,1494,1940,South,98,1233,589,Groceries,-446
13-07-2023 21:00,2629,2382,North,97,1583,928,Electronics,247
13-07-2023 22:00,3880,684,West,93,1880,964,Electronics,3196
13-07-2023 23:00,4498,2264,North,79,656,523,Clothing,2234
14-07-2023 00:00,2062,1400,North,79,841,486,Groceries,662
14-07-2023 01:00,3640,720,North,65,1473,339,Groceries,2920
14-07-2023 02:00,1186,1967,North,58,1393,763,Furniture,-781
14-07-2023 03:00,4667,1593,South,66,1725,550,Groceries,3074
14-07-2023 04:00,4671,2974,North,84,1558,357,Groceries,1697
14-07-2023 05:00,3801,2512,North,99,1979,143,Clothing,1289
14-07-2023 06:00,2877,2990,East,96,1416,267,Electronics,-113
14-07-2023 07:00,3140,1100,South,64,1688,886,Furniture,2040
14-07-2023 08:00,1085,1660,East,97,1551,290,Groceries,-575
14-07-2023 09:00,4115,1003,South,77,1895,763,Groceries,3112
14-07-2023 10:00,1136,2678,West,69,813,661,Furniture,-1542
14-07-2023 11:00,3468,717,West,82,1807,375,Clothing,2751
14-07-2023 12:00,3121,2718,South,82,1821,924,Groceries,403
14-07-2023 13:00,4619,1998,West,85,974,468,Groceries,2621
14-07-2023 14:00,2636,1111,West,62,1096,405,Furniture,1525
14-07-2023 15:00,4583,1652,South,53,1872,706,Electronics,2931
14-07-2023 16:00,4227,556,North,72,1135,853,Groceries,3671
14-07-2023 17:00,4326,1704,East,57,944,204,Groceries,2622
14-07-2023 18:00,3218,745,South,62,1730,520,Electronics,2473
14-07-2023 19:00,2751,643,South,73,916,974,Groceries,2108
14-07-2023 20:00,3217,867,South,89,938,448,Electronics,2350
14-07-2023 21:00,2787,1982,East,95,664,871,Clothing,805
14-07-2023 22:00,1871,2765,South,79,919,749,Electronics,-894
14-07-2023 23:00,3369,1115,East,79,1894,418,Electronics,2254
15-07-2023 00:00,4638,2381,East,74,1789,519,Groceries,2257
15-07-2023 01:00,3503,2088,West,82,1802,794,Groceries,1415
15-07-2023 02:00,1943,2989,North,58,1487,156,Furniture,-1046
15-07-2023 03:00,2626,1198,West,75,981,339,Groceries,1428
15-07-2023 04:00,3837,1375,South,73,1016,526,Groceries,2462
15-07-2023 05:00,3660,2185,South,82,581,716,Electronics,1475
15-07-2023 06:00,4226,1444,East,88,618,676,Clothing,2782
15-07-2023 07:00,3936,1422,West,74,1826,239,Groceries,2514
15-07-2023 08:00,1348,2246,East,94,1738,161,Electronics,-898
15-07-2023 09:00,4522,524,West,64,527,251,Furniture,3998
15-07-2023 10:00,4947,2187,West,90,1280,229,Furniture,2760
15-07-2023 11:00,2676,2059,West,97,997,530,Clothing,617
15-07-2023 12:00,2196,1583,West,98,1036,737,Clothing,613
15-07-2023 13:00,1009,933,West,90,1018,539,Clothing,76
15-07-2023 14:00,3787,1589,North,55,693,311,Electronics,2198
15-07-2023 15:00,4336,2451,South,69,1091,499,Groceries,1885
15-07-2023 16:00,2461,2653,West,93,941,773,Electronics,-192
15-07-2023 17:00,4831,595,West,65,1559,816,Furniture,4236
15-07-2023 18:00,4318,667,East,70,757,640,Furniture,3651
15-07-2023 19:00,1666,2589,South,64,612,281,Groceries,-923
15-07-2023 20:00,3593,2402,South,88,1817,150,Clothing,1191
15-07-2023 21:00,2522,2651,South,91,513,846,Furniture,-129
15-07-2023 22:00,3176,2368,West,53,1410,625,Clothing,808
15-07-2023 23:00,4743,2498,East,73,639,449,Electronics,2245
16-07-2023 00:00,1600,2829,South,52,1894,157,Clothing,-1229
16-07-2023 01:00,3652,1633,East,99,1950,518,Electronics,2019
16-07-2023 02:00,1326,2510,North,50,1620,236,Groceries,-1184
16-07-2023 03:00,4824,1248,North,79,1196,739,Clothing,3576
16-07-2023 04:00,4906,2391,East,62,1865,136,Groceries,2515
16-07-2023 05:00,1979,1330,West,67,1369,593,Clothing,649
16-07-2023 06:00,3451,548,South,89,1955,458,Furniture,2903
16-07-2023 07:00,1628,614,North,60,688,879,Groceries,1014
16-07-2023 08:00,2629,1678,North,91,581,184,Clothing,951
16-07-2023 09:00,4746,2172,East,78,1703,821,Groceries,2574
16-07-2023 10:00,4682,570,West,53,1457,750,Clothing,4112
16-07-2023 11:00,4696,1859,East,74,1397,638,Electronics,2837
16-07-2023 12:00,4430,566,East,85,1466,443,Groceries,3864
16-07-2023 13:00,4674,2016,East,85,1938,844,Furniture,2658
16-07-2023 14:00,4929,2173,East,93,1628,270,Groceries,2756
16-07-2023 15:00,3765,2277,East,89,880,789,Electronics,1488
16-07-2023 16:00,4088,1466,West,77,1221,965,Electronics,2622
16-07-2023 17:00,1273,2728,East,94,828,119,Furniture,-1455
16-07-2023 18:00,1684,2289,West,57,1772,402,Electronics,-605
16-07-2023 19:00,1115,1112,South,70,571,875,Furniture,3
16-07-2023 20:00,1860,2386,South,84,632,296,Clothing,-526
16-07-2023 21:00,3003,2122,South,93,1763,426,Electronics,881
16-07-2023 22:00,1692,1196,South,67,1601,675,Clothing,496
16-07-2023 23:00,4162,2795,North,96,1069,655,Clothing,1367
17-07-2023 00:00,2105,1737,West,74,960,855,Electronics,368
17-07-2023 01:00,3371,2906,South,95,624,111,Furniture,465
17-07-2023 02:00,4008,748,North,90,1534,460,Furniture,3260
17-07-2023 03:00,3161,1137,West,54,1991,871,Furniture,2024
17-07-2023 04:00,2792,1449,North,96,1930,395,Electronics,1343
17-07-2023 05:00,4129,2404,North,57,1440,502,Clothing,1725
17-07-2023 06:00,1153,1611,East,72,526,537,Groceries,-458
17-07-2023 07:00,2900,675,North,52,706,868,Groceries,2225
17-07-2023 08:00,2427,1222,North,93,1745,474,Electronics,1205
17-07-2023 09:00,4699,2973,West,86,811,846,Groceries,1726
17-07-2023 10:00,4926,1270,North,80,881,858,Clothing,3656
17-07-2023 11:00,2289,2447,East,78,1838,752,Groceries,-158
17-07-2023 12:00,1314,1202,South,90,1731,917,Furniture,112
17-07-2023 13:00,4786,2628,South,69,795,792,Clothing,2158
17-07-2023 14:00,2064,1426,West,52,901,599,Electronics,638
17-07-2023 15:00,1104,637,West,72,1958,525,Electronics,467
17-07-2023 16:00,2924,2897,North,89,621,976,Furniture,27
17-07-2023 17:00,2913,1649,West,70,1250,764,Groceries,1264
17-07-2023 18:00,2216,2440,North,62,605,143,Electronics,-224
17-07-2023 19:00,2424,2391,West,57,1290,208,Electronics,33
17-07-2023 20:00,4349,2378,South,54,1559,197,Clothing,1971
17-07-2023 21:00,3401,1753,South,74,571,838,Clothing,1648
17-07-2023 22:00,4063,1983,South,88,1067,544,Clothing,2080
17-07-2023 23:00,2772,1868,South,86,1690,180,Clothing,904
18-07-2023 00:00,2960,809,North,90,1744,317,Electronics,2151
18-07-2023 01:00,3780,1543,North,54,575,248,Clothing,2237
18-07-2023 02:00,2603,2170,North,57,1221,175,Furniture,433
18-07-2023 03:00,1708,2064,South,93,1509,691,Furniture,-356
18-07-2023 04:00,4327,2083,East,53,1734,663,Clothing,2244
18-07-2023 05:00,1650,2000,South,90,727,162,Clothing,-350
18-07-2023 06:00,3871,2816,South,71,952,695,Groceries,1055
18-07-2023 07:00,1946,1269,East,63,1265,493,Clothing,677
18-07-2023 08:00,1660,515,East,68,986,954,Electronics,1145
18-07-2023 09:00,3146,1105,West,62,1167,602,Furniture,2041
18-07-2023 10:00,3635,1881,South,84,1997,466,Furniture,1754
18-07-2023 11:00,3329,1312,East,53,1329,577,Electronics,2017
18-07-2023 12:00,4954,2490,West,82,1290,354,Clothing,2464
18-07-2023 13:00,3450,1394,East,71,1470,158,Groceries,2056
18-07-2023 14:00,2132,2067,East,50,989,619,Furniture,65
18-07-2023 15:00,1699,2816,West,60,875,918,Groceries,-1117
18-07-2023 16:00,3246,913,South,65,730,488,Furniture,2333
18-07-2023 17:00,4374,524,West,53,1201,687,Groceries,3850
18-07-2023 18:00,3038,2504,South,78,1748,525,Furniture,534
18-07-2023 19:00,3374,815,East,88,974,689,Groceries,2559
18-07-2023 20:00,3201,1070,West,93,1603,735,Clothing,2131
18-07-2023 21:00,1551,1224,North,87,1733,601,Clothing,327
18-07-2023 22:00,4716,2349,East,73,1820,623,Electronics,2367
18-07-2023 23:00,1404,1799,West,58,1695,379,Electronics,-395
19-07-2023 00:00,1461,2453,East,57,1612,144,Groceries,-992
19-07-2023 01:00,3179,888,West,63,725,664,Groceries,2291
19-07-2023 02:00,3838,943,South,64,642,280,Furniture,2895
19-07-2023 03:00,1873,1470,North,71,1207,500,Electronics,403
19-07-2023 04:00,1083,2915,East,86,553,473,Electronics,-1832
19-07-2023 05:00,2422,2464,North,64,695,333,Furniture,-42
19-07-2023 06:00,3801,2889,South,55,1344,285,Groceries,912
19-07-2023 07:00,3675,2328,West,50,797,904,Electronics,1347
19-07-2023 08:00,4180,803,North,69,1953,174,Groceries,3377
19-07-2023 09:00,1220,1263,West,90,1036,809,Clothing,-43
19-07-2023 10:00,4975,2473,South,85,1078,690,Groceries,2502
19-07-2023 11:00,3600,1315,East,51,999,332,Clothing,2285
19-07-2023 12:00,2391,2659,South,55,1123,267,Clothing,-268
19-07-2023 13:00,4218,1377,North,51,1340,634,Furniture,2841
19-07-2023 14:00,1111,1202,North,52,705,506,Furniture,-91
19-07-2023 15:00,1614,1443,North,56,1379,329,Clothing,171
19-07-2023 16:00,2581,2826,West,69,1660,916,Furniture,-245
19-07-2023 17:00,3971,2929,East,98,907,995,Electronics,1042
19-07-2023 18:00,4565,2560,North,90,778,746,Electronics,2005
19-07-2023 19:00,4576,802,North,90,1968,392,Groceries,3774
19-07-2023 20:00,1474,2079,North,54,1176,499,Clothing,-605
19-07-2023 21:00,3883,659,South,74,1440,137,Groceries,3224
19-07-2023 22:00,2913,2701,North,87,770,331,Clothing,212
19-07-2023 23:00,1270,2728,South,67,940,966,Clothing,-1458
20-07-2023 00:00,3468,1703,North,50,1751,267,Groceries,1765
20-07-2023 01:00,2920,2924,South,74,626,384,Groceries,-4
20-07-2023 02:00,3754,1691,West,66,1793,202,Groceries,2063
20-07-2023 03:00,2390,1673,West,95,986,244,Groceries,717
20-07-2023 04:00,4351,2563,South,64,1047,854,Electronics,1788
20-07-2023 05:00,4354,1614,East,54,1678,759,Clothing,2740
20-07-2023 06:00,1039,1643,East,66,1485,465,Furniture,-604
20-07-2023 07:00,2982,2479,South,70,1436,252,Clothing,503
20-07-2023 08:00,3236,752,West,72,1271,927,Electronics,2484
20-07-2023 09:00,4235,1932,South,92,518,521,Clothing,2303
20-07-2023 10:00,1993,2578,East,59,924,418,Electronics,-585
20-07-2023 11:00,3012,1230,South,66,1435,906,Clothing,1782
20-07-2023 12:00,4607,2836,West,50,557,737,Electronics,1771
20-07-2023 13:00,3583,997,East,86,922,803,Furniture,2586
20-07-2023 14:00,4075,1928,East,97,1343,584,Furniture,2147
20-07-2023 15:00,4906,1047,North,56,1625,182,Furniture,3859
20-07-2023 16:00,1289,1460,North,61,1599,632,Furniture,-171
20-07-2023 17:00,3480,631,East,89,565,387,Electronics,2849
20-07-2023 18:00,3518,1847,East,99,1314,895,Clothing,1671
20-07-2023 19:00,4252,1357,South,50,1674,970,Furniture,2895
20-07-2023 20:00,4319,1655,West,69,1401,588,Furniture,2664
20-07-2023 21:00,3675,2532,East,93,936,367,Clothing,1143
20-07-2023 22:00,1278,1020,West,80,1289,732,Clothing,258
20-07-2023 23:00,3924,529,East,53,1591,722,Groceries,3395
21-07-2023 00:00,1580,2551,West,75,734,178,Clothing,-971
21-07-2023 01:00,1862,1008,North,61,1174,959,Clothing,854
21-07-2023 02:00,1253,1760,East,71,597,475,Clothing,-507
21-07-2023 03:00,1180,2058,South,50,1532,696,Groceries,-878
21-07-2023 04:00,4901,515,West,50,1426,691,Clothing,4386
21-07-2023 05:00,1680,1496,East,52,1260,250,Electronics,184
21-07-2023 06:00,1824,2107,North,61,926,855,Furniture,-283
21-07-2023 07:00,4580,2339,North,70,726,829,Electronics,2241
21-07-2023 08:00,4832,2516,North,62,516,114,Groceries,2316
21-07-2023 09:00,1699,1753,North,62,1062,200,Groceries,-54
21-07-2023 10:00,3613,2243,East,90,727,879,Groceries,1370
21-07-2023 11:00,2349,2810,South,67,1205,487,Groceries,-461
21-07-2023 12:00,2380,1588,West,82,1761,134,Groceries,792
21-07-2023 13:00,4896,2812,South,55,1904,450,Furniture,2084
21-07-2023 14:00,2673,1861,West,74,1910,382,Clothing,812
21-07-2023 15:00,3727,877,South,72,1168,736,Electronics,2850
21-07-2023 16:00,3438,1698,East,73,753,835,Electronics,1740
21-07-2023 17:00,2638,975,East,86,1831,772,Clothing,1663
21-07-2023 18:00,2957,1789,West,75,1837,624,Groceries,1168
21-07-2023 19:00,4156,828,East,53,1824,264,Clothing,3328
21-07-2023 20:00,4388,2339,West,87,617,527,Groceries,2049
21-07-2023 21:00,1211,1686,South,84,549,357,Furniture,-475
21-07-2023 22:00,2538,937,East,98,1704,904,Electronics,1601
21-07-2023 23:00,1383,1890,East,60,1042,542,Electronics,-507
22-07-2023 00:00,2714,2273,West,85,826,725,Furniture,441
22-07-2023 01:00,1341,1722,West,74,1443,219,Furniture,-381
22-07-2023 02:00,2838,2023,West,69,1769,168,Groceries,815
22-07-2023 03:00,2987,2563,West,50,1101,373,Clothing,424
22-07-2023 04:00,1843,2344,North,79,601,659,Groceries,-501
22-07-2023 05:00,4109,1819,West,53,1753,948,Groceries,2290
22-07-2023 06:00,2534,1367,North,72,887,421,Electronics,1167
22-07-2023 07:00,1419,2311,South,84,1734,461,Groceries,-892
22-07-2023 08:00,3798,1483,West,91,1148,669,Clothing,2315
22-07-2023 09:00,4240,1762,North,71,1953,689,Groceries,2478
22-07-2023 10:00,2988,1824,North,80,838,598,Electronics,1164
22-07-2023 11:00,2932,2553,North,50,683,303,Clothing,379
22-07-2023 12:00,4414,1518,East,53,555,836,Clothing,2896
22-07-2023 13:00,2849,2289,North,68,1478,874,Electronics,560
22-07-2023 14:00,1305,1306,West,79,1805,605,Electronics,-1
22-07-2023 15:00,4613,2393,West,50,1071,714,Groceries,2220
22-07-2023 16:00,3749,1909,West,97,1651,208,Electronics,1840
22-07-2023 17:00,1868,1818,North,68,1216,364,Furniture,50
22-07-2023 18:00,3584,1641,North,70,1507,936,Electronics,1943
22-07-2023 19:00,2135,904,East,71,715,487,Furniture,1231
22-07-2023 20:00,2434,2286,South,99,1613,515,Electronics,148
22-07-2023 21:00,1205,1093,East,51,1443,667,Furniture,112
22-07-2023 22:00,4256,511,West,55,813,411,Furniture,3745
22-07-2023 23:00,4453,2712,West,70,732,351,Electronics,1741
23-07-2023 00:00,1495,1817,West,82,1244,911,Clothing,-322
23-07-2023 01:00,4450,2042,East,68,1074,683,Clothing,2408
23-07-2023 02:00,4118,2625,West,76,1387,752,Furniture,1493
23-07-2023 03:00,2909,1113,West,86,746,487,Clothing,1796
23-07-2023 04:00,4811,2486,West,78,941,791,Electronics,2325
23-07-2023 05:00,4622,1368,North,77,634,302,Furniture,3254
23-07-2023 06:00,4599,1311,South,83,1515,882,Groceries,3288
23-07-2023 07:00,3551,2322,North,50,1525,987,Furniture,1229
23-07-2023 08:00,2045,1266,North,97,660,209,Groceries,779
23-07-2023 09:00,1212,581,South,74,639,181,Groceries,631
23-07-2023 10:00,1309,2244,South,70,803,695,Furniture,-935
23-07-2023 11:00,3708,2756,East,83,1983,868,Groceries,952
23-07-2023 12:00,2991,1021,South,75,624,292,Clothing,1970
23-07-2023 13:00,3800,1827,East,85,1436,238,Groceries,1973
23-07-2023 14:00,1271,1493,East,84,1870,320,Clothing,-222
23-07-2023 15:00,4642,2025,North,72,1847,288,Furniture,2617
23-07-2023 16:00,2822,1969,West,66,906,960,Groceries,853
23-07-2023 17:00,3985,2013,North,96,1992,955,Groceries,1972
23-07-2023 18:00,4273,1280,North,91,663,439,Clothing,2993
23-07-2023 19:00,3079,1951,South,61,1361,577,Clothing,1128
23-07-2023 20:00,1442,1058,South,93,739,521,Furniture,384
23-07-2023 21:00,3209,2638,East,69,1736,296,Furniture,571
23-07-2023 22:00,3814,2537,East,88,648,912,Groceries,1277
23-07-2023 23:00,1253,2253,East,76,1083,685,Electronics,-1000
24-07-2023 00:00,1520,1359,South,91,1626,297,Groceries,161
24-07-2023 01:00,1976,2112,East,86,1706,423,Groceries,-136
24-07-2023 02:00,4722,1055,East,69,1004,359,Furniture,3667
24-07-2023 03:00,4551,655,South,60,1024,298,Furniture,3896
24-07-2023 04:00,1009,2549,West,77,1903,915,Groceries,-1540
24-07-2023 05:00,3773,1880,North,51,1274,964,Clothing,1893
24-07-2023 06:00,3552,1324,South,73,1547,236,Furniture,2228
24-07-2023 07:00,3832,2092,East,65,1200,445,Groceries,1740
24-07-2023 08:00,4907,1581,North,61,1656,599,Electronics,3326
24-07-2023 09:00,2583,1703,South,65,1517,274,Groceries,880
24-07-2023 10:00,3483,992,North,85,549,588,Electronics,2491
24-07-2023 11:00,2134,1168,North,51,1457,568,Electronics,966
24-07-2023 12:00,1152,574,West,74,1194,415,Electronics,578
24-07-2023 13:00,2658,870,East,78,525,919,Groceries,1788
24-07-2023 14:00,3964,1086,South,77,1149,479,Furniture,2878
24-07-2023 15:00,3916,828,East,59,510,953,Clothing,3088
24-07-2023 16:00,4173,1089,West,94,1307,541,Clothing,3084
24-07-2023 17:00,3800,2290,West,72,1625,964,Groceries,1510
24-07-2023 18:00,2856,1276,South,81,510,915,Groceries,1580
24-07-2023 19:00,2214,2522,South,80,1635,232,Electronics,-308
24-07-2023 20:00,2752,2851,West,68,1271,126,Furniture,-99
24-07-2023 21:00,3610,1078,South,64,1269,356,Groceries,2532
24-07-2023 22:00,4875,720,North,82,1472,662,Clothing,4155
24-07-2023 23:00,2104,1687,North,66,1690,755,Groceries,417
25-07-2023 00:00,3536,2003,West,85,906,966,Furniture,1533
25-07-2023 01:00,1894,2922,East,69,1568,455,Furniture,-1028
25-07-2023 02:00,2111,2207,South,58,1341,335,Groceries,-96
25-07-2023 03:00,4265,2245,South,87,1216,771,Groceries,2020
25-07-2023 04:00,1103,687,North,52,858,458,Furniture,416
25-07-2023 05:00,4854,1714,South,51,1053,914,Furniture,3140
25-07-2023 06:00,4167,1609,East,67,784,370,Electronics,2558
25-07-2023 07:00,4494,1343,South,72,899,765,Groceries,3151
25-07-2023 08:00,2914,1030,South,68,1974,648,Groceries,1884
25-07-2023 09:00,4269,1570,North,56,1967,609,Groceries,2699
25-07-2023 10:00,4072,1462,South,84,887,828,Clothing,2610
25-07-2023 11:00,2006,1669,West,99,1879,538,Electronics,337
25-07-2023 12:00,1406,1905,West,69,1283,741,Furniture,-499
25-07-2023 13:00,2401,1016,East,69,924,687,Electronics,1385
25-07-2023 14:00,1166,2388,East,68,1529,899,Clothing,-1222
25-07-2023 15:00,1508,2973,East,90,940,570,Electronics,-1465
25-07-2023 16:00,2661,1991,East,65,855,808,Clothing,670
25-07-2023 17:00,3360,1617,North,87,1418,410,Electronics,1743
25-07-2023 18:00,4664,632,South,70,1264,316,Electronics,4032
25-07-2023 19:00,4489,813,North,78,1053,710,Electronics,3676
25-07-2023 20:00,1762,1090,East,93,767,411,Groceries,672
25-07-2023 21:00,1680,2043,South,87,1491,896,Furniture,-363
25-07-2023 22:00,3524,2706,West,94,1740,329,Electronics,818
25-07-2023 23:00,3120,2385,North,73,563,720,Groceries,735
26-07-2023 00:00,2164,2126,South,86,941,439,Groceries,38
26-07-2023 01:00,1581,1247,West,78,1040,594,Groceries,334
26-07-2023 02:00,1261,1997,West,80,1798,263,Clothing,-736
26-07-2023 03:00,2363,1300,East,94,969,215,Electronics,1063
26-07-2023 04:00,2331,2957,West,88,1739,170,Furniture,-626
26-07-2023 05:00,3292,1997,West,61,1377,825,Electronics,1295
26-07-2023 06:00,2538,1879,East,79,1717,949,Electronics,659
26-07-2023 07:00,4408,1179,South,53,1211,152,Furniture,3229
26-07-2023 08:00,4646,2661,South,79,512,696,Groceries,1985
26-07-2023 09:00,1560,1396,East,54,721,441,Electronics,164
26-07-2023 10:00,2099,2046,North,65,1919,687,Groceries,53
26-07-2023 11:00,2903,2293,East,76,1380,878,Groceries,610
26-07-2023 12:00,1174,2612,South,53,1338,859,Groceries,-1438
26-07-2023 13:00,3156,1183,North,57,1251,431,Furniture,1973
26-07-2023 14:00,3230,1795,East,97,769,897,Groceries,1435
26-07-2023 15:00,1191,2185,South,57,1821,178,Electronics,-994
26-07-2023 16:00,1064,1885,South,66,1231,206,Groceries,-821
26-07-2023 17:00,4920,2693,South,95,1343,181,Clothing,2227
26-07-2023 18:00,4010,1442,West,93,1115,301,Clothing,2568
26-07-2023 19:00,2497,1809,West,52,1955,491,Clothing,688
26-07-2023 20:00,4854,1533,North,76,1931,329,Groceries,3321
26-07-2023 21:00,4171,2733,North,83,564,838,Electronics,1438
26-07-2023 22:00,2567,2120,North,94,1561,119,Electronics,447
26-07-2023 23:00,3911,1308,West,70,527,879,Groceries,2603
27-07-2023 00:00,2151,670,North,92,1812,422,Groceries,1481
27-07-2023 01:00,4523,2760,South,73,736,567,Furniture,1763
27-07-2023 02:00,2937,2053,South,93,1649,789,Groceries,884
27-07-2023 03:00,1368,2095,North,99,883,993,Clothing,-727
27-07-2023 04:00,1850,2123,North,90,825,751,Furniture,-273
27-07-2023 05:00,1042,526,West,78,584,409,Furniture,516
27-07-2023 06:00,2907,1513,South,88,1248,571,Groceries,1394
27-07-2023 07:00,4490,1591,East,55,745,691,Groceries,2899
27-07-2023 08:00,3535,907,East,63,887,991,Furniture,2628
27-07-2023 09:00,1077,1632,West,99,1428,793,Furniture,-555
27-07-2023 10:00,3873,573,West,63,765,173,Furniture,3300
27-07-2023 11:00,2824,1179,West,86,1260,758,Furniture,1645
27-07-2023 12:00,2293,1891,South,73,1303,844,Furniture,402
27-07-2023 13:00,1673,1348,North,62,1728,753,Electronics,325
27-07-2023 14:00,1700,1369,North,50,727,535,Furniture,331
27-07-2023 15:00,1758,736,West,61,739,561,Furniture,1022
27-07-2023 16:00,2923,2925,South,91,1596,249,Electronics,-2
27-07-2023 17:00,3775,1405,East,73,887,743,Clothing,2370
27-07-2023 18:00,4386,2923,West,86,877,850,Clothing,1463
27-07-2023 19:00,3972,1118,South,69,711,983,Clothing,2854
27-07-2023 20:00,4922,1532,West,55,1294,414,Clothing,3390
27-07-2023 21:00,1901,2743,South,61,1175,773,Groceries,-842
27-07-2023 22:00,3936,1813,South,70,1148,931,Groceries,2123
27-07-2023 23:00,1992,1346,West,52,670,349,Furniture,646
28-07-2023 00:00,2191,2423,North,76,1675,739,Furniture,-232
28-07-2023 01:00,3386,1133,West,95,1308,373,Clothing,2253
28-07-2023 02:00,3240,1517,North,85,603,581,Clothing,1723
28-07-2023 03:00,2476,507,North,66,1745,181,Electronics,1969
28-07-2023 04:00,3330,1892,East,98,1805,331,Electronics,1438
28-07-2023 05:00,4407,1568,South,95,1911,130,Electronics,2839
28-07-2023 06:00,1389,2891,West,64,871,845,Clothing,-1502
28-07-2023 07:00,1999,2280,South,88,628,183,Electronics,-281
28-07-2023 08:00,1524,2142,East,53,1927,141,Furniture,-618
28-07-2023 09:00,4311,1716,North,66,719,813,Clothing,2595
28-07-2023 10:00,2855,1348,West,87,1696,350,Groceries,1507
28-07-2023 11:00,2506,1880,South,60,971,609,Clothing,626
28-07-2023 12:00,1658,561,East,61,1487,486,Groceries,1097
28-07-2023 13:00,3763,1585,North,96,1976,696,Groceries,2178
28-07-2023 14:00,4663,2969,North,81,1107,794,Clothing,1694
28-07-2023 15:00,1890,2317,South,76,1575,365,Electronics,-427
28-07-2023 16:00,4626,1132,North,93,593,682,Furniture,3494
28-07-2023 17:00,2481,1291,East,92,1544,121,Clothing,1190
28-07-2023 18:00,4160,1800,North,76,605,506,Electronics,2360
28-07-2023 19:00,4731,1954,West,98,1723,175,Groceries,2777
28-07-2023 20:00,4166,1638,West,89,1875,586,Groceries,2528
28-07-2023 21:00,1451,2211,South,93,1804,880,Groceries,-760
28-07-2023 22:00,3475,1024,East,78,1805,779,Groceries,2451
28-07-2023 23:00,4222,2520,North,58,1111,990,Clothing,1702
29-07-2023 00:00,2537,1398,North,92,1348,964,Furniture,1139
29-07-2023 01:00,4447,2710,North,52,1768,450,Groceries,1737
29-07-2023 02:00,4093,1286,West,88,1447,339,Electronics,2807
29-07-2023 03:00,1882,1860,East,78,1353,150,Electronics,22
29-07-2023 04:00,1312,2926,North,70,928,575,Furniture,-1614
29-07-2023 05:00,1839,672,South,84,1561,694,Furniture,1167
29-07-2023 06:00,3566,1499,East,97,1942,963,Furniture,2067
29-07-2023 07:00,4277,2310,East,59,801,701,Groceries,1967
29-07-2023 08:00,1374,563,North,72,1138,993,Clothing,811
29-07-2023 09:00,1450,1845,West,88,570,624,Groceries,-395
29-07-2023 10:00,4697,1474,East,74,1145,256,Groceries,3223
29-07-2023 11:00,4855,565,South,73,1024,298,Electronics,4290
29-07-2023 12:00,4062,2366,East,69,673,530,Clothing,1696
29-07-2023 13:00,1594,2122,West,64,589,765,Clothing,-528
29-07-2023 14:00,4250,957,South,70,867,809,Electronics,3293
29-07-2023 15:00,2233,2102,West,91,1300,835,Electronics,131
29-07-2023 16:00,1499,2457,North,61,1730,217,Electronics,-958
29-07-2023 17:00,1463,2240,East,67,1585,762,Furniture,-777
29-07-2023 18:00,4911,1949,South,72,818,855,Clothing,2962
29-07-2023 19:00,4195,2459,West,90,1323,174,Electronics,1736
29-07-2023 20:00,1112,2725,North,78,1050,824,Electronics,-1613
29-07-2023 21:00,2035,2454,South,90,559,886,Electronics,-419
29-07-2023 22:00,4197,779,East,85,1628,965,Groceries,3418
29-07-2023 23:00,4636,2891,East,54,1762,466,Clothing,1745
30-07-2023 00:00,3378,1540,West,88,1985,855,Clothing,1838
30-07-2023 01:00,2924,2843,South,75,626,277,Furniture,81
30-07-2023 02:00,4354,2749,North,88,582,207,Groceries,1605
30-07-2023 03:00,1139,1461,North,60,1743,902,Clothing,-322
30-07-2023 04:00,2424,2442,North,91,1931,788,Furniture,-18
30-07-2023 05:00,3949,1717,West,60,1445,578,Furniture,2232
30-07-2023 06:00,4168,874,North,67,1085,785,Electronics,3294
30-07-2023 07:00,1516,2411,South,61,1146,192,Furniture,-895
30-07-2023 08:00,3616,534,West,65,1953,199,Furniture,3082
30-07-2023 09:00,2947,1892,East,76,1389,280,Groceries,1055
30-07-2023 10:00,3893,2576,West,85,1073,770,Electronics,1317
30-07-2023 11:00,4140,1274,West,66,1012,195,Electronics,2866
30-07-2023 12:00,3165,720,West,98,1602,331,Electronics,2445
30-07-2023 13:00,1887,2600,South,70,564,350,Furniture,-713
30-07-2023 14:00,4130,2623,East,86,682,951,Electronics,1507
30-07-2023 15:00,4104,993,East,80,1589,678,Clothing,3111
30-07-2023 16:00,2341,2211,West,94,1334,848,Groceries,130
30-07-2023 17:00,1049,2664,West,84,1731,118,Groceries,-1615
30-07-2023 18:00,4951,779,West,76,553,386,Furniture,4172
30-07-2023 19:00,4560,1245,South,72,1744,899,Electronics,3315
30-07-2023 20:00,1018,2842,South,81,735,306,Groceries,-1824
30-07-2023 21:00,1725,1974,North,66,1388,410,Furniture,-249
30-07-2023 22:00,3244,2357,East,60,1111,202,Furniture,887
30-07-2023 23:00,4962,2041,North,50,1458,258,Groceries,2921
31-07-2023 00:00,2473,1596,North,77,937,806,Electronics,877
31-07-2023 01:00,3606,1559,West,67,1503,662,Electronics,2047
31-07-2023 02:00,4750,2422,South,98,1626,477,Clothing,2328
31-07-2023 03:00,1451,2505,North,90,1959,323,Clothing,-1054
31-07-2023 04:00,3336,996,North,69,1193,813,Electronics,2340
31-07-2023 05:00,2164,2753,North,56,1462,191,Clothing,-589
31-07-2023 06:00,2107,2973,West,86,1944,766,Clothing,-866
31-07-2023 07:00,4765,543,West,65,1631,275,Groceries,4222
31-07-2023 08:00,3438,2351,South,88,1023,209,Electronics,1087
31-07-2023 09:00,4662,953,North,94,1966,910,Groceries,3709
31-07-2023 10:00,1214,1094,North,94,903,834,Groceries,120
31-07-2023 11:00,2549,1856,South,96,842,278,Furniture,693
31-07-2023 12:00,3262,1006,South,72,1299,837,Electronics,2256
31-07-2023 13:00,4474,1293,South,81,1850,552,Groceries,3181
31-07-2023 14:00,1127,520,East,98,713,174,Clothing,607
31-07-2023 15:00,2845,1899,South,66,1523,682,Furniture,946
31-07-2023 16:00,4548,2961,West,68,821,939,Clothing,1587
31-07-2023 17:00,1759,1594,East,91,1601,820,Furniture,165
31-07-2023 18:00,3451,1927,South,83,1578,591,Clothing,1524
31-07-2023 19:00,4100,2085,West,63,1283,202,Clothing,2015
31-07-2023 20:00,2815,2314,South,52,1355,140,Clothing,501
31-07-2023 21:00,3385,1920,South,88,1594,534,Groceries,1465
31-07-2023 22:00,3878,836,East,74,1591,433,Electronics,3042
31-07-2023 23:00,3761,2167,West,60,679,379,Furniture,1594
01-08-2023 00:00,1360,1409,North,98,879,641,Groceries,-49
01-08-2023 01:00,1568,775,South,64,1432,605,Furniture,793
01-08-2023 02:00,2415,1391,East,68,949,342,Groceries,1024
01-08-2023 03:00,3265,512,West,92,1784,663,Furniture,2753
01-08-2023 04:00,2597,1526,South,64,1970,668,Furniture,1071
01-08-2023 05:00,2692,1473,North,64,630,801,Clothing,1219
01-08-2023 06:00,1201,674,West,87,1757,178,Furniture,527
01-08-2023 07:00,3064,1908,West,64,1403,984,Furniture,1156
01-08-2023 08:00,3369,2125,East,58,1677,536,Clothing,1244
01-08-2023 09:00,1517,2443,South,54,829,807,Groceries,-926
01-08-2023 10:00,4641,2788,South,68,1136,560,Groceries,1853
01-08-2023 11:00,2348,1046,West,73,552,296,Electronics,1302
01-08-2023 12:00,2435,2561,South,78,967,130,Electronics,-126
01-08-2023 13:00,2341,1718,West,54,1139,943,Electronics,623
01-08-2023 14:00,1680,1920,North,71,912,129,Electronics,-240
01-08-2023 15:00,2988,1954,East,62,1537,212,Furniture,1034
01-08-2023 16:00,4153,1933,South,99,995,749,Furniture,2220
01-08-2023 17:00,4545,502,South,98,867,833,Electronics,4043
01-08-2023 18:00,2491,2342,East,96,1038,783,Clothing,149
01-08-2023 19:00,1424,1246,North,95,1136,489,Electronics,178
01-08-2023 20:00,2968,1371,North,78,1975,766,Groceries,1597
01-08-2023 21:00,4802,994,North,65,1014,375,Furniture,3808
01-08-2023 22:00,2712,2964,North,85,980,319,Clothing,-252
01-08-2023 23:00,4275,1914,North,66,913,375,Groceries,2361
02-08-2023 00:00,4654,1127,West,69,727,111,Clothing,3527
02-08-2023 01:00,4066,1575,South,63,636,592,Clothing,2491
02-08-2023 02:00,3434,641,South,99,1763,696,Electronics,2793
02-08-2023 03:00,1777,1987,South,55,1290,833,Groceries,-210
02-08-2023 04:00,3145,545,West,71,1334,148,Electronics,2600
02-08-2023 05:00,4416,2557,East,89,971,791,Groceries,1859
02-08-2023 06:00,2826,1163,North,58,1017,109,Furniture,1663
02-08-2023 07:00,1207,1072,East,81,1984,360,Groceries,135
02-08-2023 08:00,2537,2529,North,73,804,419,Furniture,8
02-08-2023 09:00,2659,2053,North,82,1154,285,Furniture,606
02-08-2023 10:00,4863,2121,East,62,680,328,Electronics,2742
02-08-2023 11:00,3633,1412,South,84,529,769,Furniture,2221
02-08-2023 12:00,3213,1139,West,55,1471,884,Electronics,2074
02-08-2023 13:00,1021,1408,East,98,1264,934,Clothing,-387
02-08-2023 14:00,1153,2725,South,89,539,120,Clothing,-1572
02-08-2023 15:00,2962,1368,North,79,686,115,Clothing,1594
02-08-2023 16:00,4510,1529,South,87,818,579,Groceries,2981
02-08-2023 17:00,4366,1352,North,65,1750,894,Furniture,3014
02-08-2023 18:00,1218,806,North,50,1231,726,Electronics,412
02-08-2023 19:00,1668,2874,South,91,1391,105,Clothing,-1206
02-08-2023 20:00,2518,2316,North,67,823,397,Electronics,202
02-08-2023 21:00,3277,894,West,71,1442,358,Clothing,2383
02-08-2023 22:00,3067,2847,South,75,1566,139,Furniture,220
02-08-2023 23:00,3600,1248,East,63,1155,375,Clothing,2352
03-08-2023 00:00,1949,2832,North,86,1801,843,Electronics,-883
03-08-2023 01:00,3195,829,North,98,1842,618,Clothing,2366
03-08-2023 02:00,4179,2597,West,63,673,926,Electronics,1582
03-08-2023 03:00,1402,2531,West,75,1184,704,Clothing,-1129
03-08-2023 04:00,1595,1272,East,99,1564,610,Electronics,323
03-08-2023 05:00,4554,2145,North,85,908,407,Clothing,2409
03-08-2023 06:00,3414,2232,East,72,1846,998,Furniture,1182
03-08-2023 07:00,4905,877,East,51,679,632,Clothing,4028
03-08-2023 08:00,2437,2287,North,88,1353,579,Groceries,150
03-08-2023 09:00,4380,2123,East,56,1682,513,Electronics,2257
03-08-2023 10:00,3849,1499,East,88,536,622,Clothing,2350
03-08-2023 11:00,3965,2348,West,94,905,564,Groceries,1617
03-08-2023 12:00,4906,2061,West,71,1038,508,Electronics,2845
03-08-2023 13:00,2157,1273,East,77,875,149,Clothing,884
03-08-2023 14:00,2742,1583,North,87,755,876,Clothing,1159
03-08-2023 15:00,2306,2303,West,69,777,144,Furniture,3
03-08-2023 16:00,4849,1598,East,98,748,896,Clothing,3251
03-08-2023 17:00,1072,2550,South,67,1192,929,Electronics,-1478
03-08-2023 18:00,1480,2098,South,73,1540,370,Groceries,-618
03-08-2023 19:00,4423,1247,East,82,1891,374,Clothing,3176
03-08-2023 20:00,1559,1971,South,94,624,522,Groceries,-412
03-08-2023 21:00,4397,2264,West,75,1835,134,Electronics,2133
03-08-2023 22:00,1744,2822,North,68,711,603,Electronics,-1078
03-08-2023 23:00,2466,2053,East,97,971,587,Clothing,413
04-08-2023 00:00,1099,2115,West,91,1248,752,Furniture,-1016
04-08-2023 01:00,2082,2762,North,62,1938,243,Clothing,-680
04-08-2023 02:00,3555,2008,South,59,999,934,Furniture,1547
04-08-2023 03:00,3305,828,South,63,1310,856,Clothing,2477
04-08-2023 04:00,1412,2802,South,58,1388,962,Groceries,-1390
04-08-2023 05:00,4523,1910,South,60,1704,922,Furniture,2613
04-08-2023 06:00,2088,625,West,52,1912,292,Furniture,1463
04-08-2023 07:00,3642,1266,West,89,1710,646,Groceries,2376
04-08-2023 08:00,2177,2073,North,61,1991,883,Clothing,104
04-08-2023 09:00,3008,1727,East,84,1980,996,Electronics,1281
04-08-2023 10:00,3313,1695,North,88,1657,277,Electronics,1618
04-08-2023 11:00,1820,2258,East,95,674,881,Clothing,-438
04-08-2023 12:00,4150,716,South,88,1784,417,Groceries,3434
04-08-2023 13:00,4386,1859,South,81,816,490,Electronics,2527
04-08-2023 14:00,1661,1821,South,88,1500,250,Groceries,-160
04-08-2023 15:00,3994,1331,South,63,1323,710,Clothing,2663
04-08-2023 16:00,1559,681,West,93,1369,546,Groceries,878
04-08-2023 17:00,3964,833,North,50,1430,640,Groceries,3131
04-08-2023 18:00,3938,1010,East,76,1386,249,Groceries,2928
04-08-2023 19:00,2271,882,East,86,768,307,Electronics,1389
04-08-2023 20:00,2813,2396,West,92,969,448,Groceries,417
04-08-2023 21:00,3915,831,South,50,723,361,Furniture,3084
04-08-2023 22:00,1609,1688,North,94,1775,821,Groceries,-79
04-08-2023 23:00,3461,1765,South,78,1587,512,Groceries,1696
05-08-2023 00:00,1024,1399,West,73,1474,188,Clothing,-375
05-08-2023 01:00,3028,1141,East,66,1406,848,Groceries,1887
05-08-2023 02:00,1283,1750,West,84,1329,859,Groceries,-467
05-08-2023 03:00,2472,1133,East,80,1987,357,Electronics,1339
05-08-2023 04:00,3928,2998,North,91,1647,591,Furniture,930
05-08-2023 05:00,1300,695,East,81,737,803,Clothing,605
05-08-2023 06:00,2091,2393,North,68,574,707,Furniture,-302
05-08-2023 07:00,2030,957,South,80,1965,647,Groceries,1073
05-08-2023 08:00,1816,1329,South,88,999,195,Electronics,487
05-08-2023 09:00,4208,2804,West,69,767,503,Furniture,1404
05-08-2023 10:00,4235,2556,North,77,1486,538,Furniture,1679
05-08-2023 11:00,1082,1724,South,52,1573,136,Furniture,-642
05-08-2023 12:00,2920,1386,North,81,1582,845,Furniture,1534
05-08-2023 13:00,4721,892,South,71,1977,713,Furniture,3829
05-08-2023 14:00,4491,2175,South,93,1222,580,Electronics,2316
05-08-2023 15:00,4144,2946,East,91,1595,279,Groceries,1198
05-08-2023 16:00,4308,2878,West,93,689,424,Electronics,1430
05-08-2023 17:00,3093,2681,East,64,1495,681,Electronics,412
05-08-2023 18:00,1617,1415,North,87,1065,505,Electronics,202
05-08-2023 19:00,3975,1434,South,68,1492,568,Electronics,2541
05-08-2023 20:00,4871,854,West,80,1235,718,Groceries,4017
05-08-2023 21:00,3309,2021,South,75,655,370,Groceries,1288
05-08-2023 22:00,1175,2837,South,54,1172,453,Electronics,-1662
05-08-2023 23:00,2189,1128,East,69,1608,658,Furniture,1061
06-08-2023 00:00,3704,1670,North,51,568,564,Groceries,2034
06-08-2023 01:00,1841,826,West,70,1908,719,Groceries,1015
06-08-2023 02:00,1369,1938,West,85,872,463,Electronics,-569
06-08-2023 03:00,2818,2757,West,77,554,168,Furniture,61
06-08-2023 04:00,3101,1921,North,69,584,407,Furniture,1180
06-08-2023 05:00,1689,1626,West,86,1440,522,Electronics,63
06-08-2023 06:00,4490,2280,North,88,1340,613,Electronics,2210
06-08-2023 07:00,2779,2031,West,85,1091,318,Groceries,748
06-08-2023 08:00,4578,2414,South,60,1231,144,Groceries,2164
06-08-2023 09:00,2364,1732,North,52,1121,332,Clothing,632
06-08-2023 10:00,4198,2456,East,86,1508,800,Clothing,1742
06-08-2023 11:00,2432,2975,West,69,816,466,Electronics,-543
06-08-2023 12:00,4995,892,East,81,1687,959,Clothing,4103
06-08-2023 13:00,1366,1325,North,96,1124,221,Furniture,41
06-08-2023 14:00,4342,2412,South,74,751,594,Furniture,1930
06-08-2023 15:00,1643,2895,East,70,651,676,Furniture,-1252
06-08-2023 16:00,4676,549,East,99,1859,983,Groceries,4127
06-08-2023 17:00,3426,1896,South,65,1409,248,Clothing,1530
06-08-2023 18:00,1072,1550,South,97,1891,860,Clothing,-478
06-08-2023 19:00,4994,1299,North,91,1365,994,Electronics,3695
06-08-2023 20:00,4993,2292,West,50,1099,575,Groceries,2701
06-08-2023 21:00,3962,1863,East,72,1506,678,Groceries,2099
06-08-2023 22:00,2271,2848,East,92,1470,449,Groceries,-577
06-08-2023 23:00,1859,2065,North,98,1504,996,Furniture,-206
07-08-2023 00:00,4856,2713,West,73,1623,670,Groceries,2143
07-08-2023 01:00,1042,2863,North,96,1643,214,Clothing,-1821
07-08-2023 02:00,3424,500,East,74,1908,727,Electronics,2924
07-08-2023 03:00,2064,1519,East,56,802,336,Clothing,545
07-08-2023 04:00,3217,1784,South,87,1672,146,Groceries,1433
07-08-2023 05:00,3259,562,South,96,1724,720,Electronics,2697
07-08-2023 06:00,2516,2369,West,96,1526,373,Furniture,147
07-08-2023 07:00,4751,2769,East,88,899,212,Electronics,1982
07-08-2023 08:00,3086,651,East,84,567,644,Groceries,2435
07-08-2023 09:00,1368,1143,South,63,653,498,Groceries,225
07-08-2023 10:00,3804,1125,North,58,1514,891,Electronics,2679
07-08-2023 11:00,1150,716,North,52,681,391,Groceries,434
07-08-2023 12:00,2134,695,East,87,1024,415,Groceries,1439
07-08-2023 13:00,2503,1514,East,69,688,261,Groceries,989
07-08-2023 14:00,2459,2021,West,90,519,189,Groceries,438
07-08-2023 15:00,2070,2078,West,82,1350,150,Electronics,-8
07-08-2023 16:00,2023,1580,South,90,1806,523,Electronics,443
07-08-2023 17:00,2598,2027,East,93,1397,505,Clothing,571
07-08-2023 18:00,3784,1221,North,81,509,243,Furniture,2563
07-08-2023 19:00,3040,2107,West,85,1199,715,Furniture,933
07-08-2023 20:00,2389,2259,South,75,1154,781,Clothing,130
07-08-2023 21:00,1068,2062,South,97,1826,627,Electronics,-994
07-08-2023 22:00,3346,1139,North,54,740,232,Clothing,2207
07-08-2023 23:00,1943,2653,West,98,651,598,Groceries,-710
08-08-2023 00:00,1801,664,North,79,1283,489,Groceries,1137
08-08-2023 01:00,3343,714,South,66,1860,269,Furniture,2629
08-08-2023 02:00,3250,1594,East,55,687,641,Electronics,1656
08-08-2023 03:00,1060,589,North,64,963,259,Furniture,471
08-08-2023 04:00,1945,2295,South,50,1221,758,Clothing,-350
08-08-2023 05:00,4010,1751,East,62,1700,918,Furniture,2259
08-08-2023 06:00,4901,1602,East,97,1399,848,Furniture,3299
08-08-2023 07:00,2337,1107,West,83,1205,511,Groceries,1230
08-08-2023 08:00,2184,848,West,79,1700,786,Furniture,1336
08-08-2023 09:00,1330,745,South,68,1380,683,Clothing,585
08-08-2023 10:00,2551,771,North,51,914,483,Electronics,1780
08-08-2023 11:00,1337,2530,East,93,1077,974,Furniture,-1193
08-08-2023 12:00,2629,902,West,61,809,738,Electronics,1727
08-08-2023 13:00,2327,1965,West,89,1525,996,Clothing,362
08-08-2023 14:00,2526,1695,North,93,816,807,Furniture,831
08-08-2023 15:00,2673,1579,West,73,1519,284,Electronics,1094
08-08-2023 16:00,2361,2114,South,60,867,761,Groceries,247
08-08-2023 17:00,2573,1626,North,51,1054,313,Groceries,947
08-08-2023 18:00,3686,783,East,50,1104,193,Clothing,2903
08-08-2023 19:00,1274,1016,South,77,1749,669,Furniture,258
08-08-2023 20:00,2187,1801,East,53,1435,318,Clothing,386
08-08-2023 21:00,4514,1111,East,90,979,318,Electronics,3403
08-08-2023 22:00,3366,1249,West,79,1480,112,Electronics,2117
08-08-2023 23:00,3636,1792,South,56,1586,522,Clothing,1844
09-08-2023 00:00,3551,2356,South,71,1803,894,Electronics,1195
09-08-2023 01:00,4757,899,North,75,1439,522,Clothing,3858
09-08-2023 02:00,3434,2026,South,78,513,585,Clothing,1408
09-08-2023 03:00,2993,2524,North,74,527,476,Groceries,469
09-08-2023 04:00,1869,2633,South,59,641,751,Electronics,-764
09-08-2023 05:00,3880,819,East,69,1089,507,Clothing,3061
09-08-2023 06:00,2014,1555,North,63,972,885,Groceries,459
09-08-2023 07:00,2911,835,South,82,1707,218,Clothing,2076
09-08-2023 08:00,1602,2598,North,54,816,370,Electronics,-996
09-08-2023 09:00,4821,673,West,94,1884,196,Groceries,4148
09-08-2023 10:00,2799,2141,West,55,944,941,Electronics,658
09-08-2023 11:00,1690,1000,North,71,795,146,Furniture,690
09-08-2023 12:00,1493,2623,North,66,903,763,Furniture,-1130
09-08-2023 13:00,1489,2863,East,64,1251,272,Furniture,-1374
09-08-2023 14:00,3768,2356,South,88,762,886,Furniture,1412
09-08-2023 15:00,4144,2396,West,89,1346,446,Groceries,1748
09-08-2023 16:00,3556,2163,West,77,876,336,Electronics,1393
09-08-2023 17:00,1389,2218,South,51,1084,642,Clothing,-829
09-08-2023 18:00,4690,2278,West,67,1591,312,Clothing,2412
09-08-2023 19:00,4928,1196,West,76,1298,371,Clothing,3732
09-08-2023 20:00,1294,1231,North,70,970,506,Electronics,63
09-08-2023 21:00,2392,1594,West,72,1231,177,Groceries,798
09-08-2023 22:00,3843,1151,West,56,1471,890,Electronics,2692
09-08-2023 23:00,3912,1594,West,97,546,652,Furniture,2318
10-08-2023 00:00,2717,545,South,68,1446,245,Clothing,2172
10-08-2023 01:00,3596,1570,East,58,1581,111,Electronics,2026
10-08-2023 02:00,1648,1945,North,61,523,859,Furniture,-297
10-08-2023 03:00,2873,2696,East,95,1813,328,Furniture,177
10-08-2023 04:00,1567,955,West,79,1330,942,Groceries,612
10-08-2023 05:00,4258,2162,West,56,1967,790,Clothing,2096
10-08-2023 06:00,3900,1465,West,51,902,440,Electronics,2435
10-08-2023 07:00,3817,2520,East,66,1547,771,Furniture,1297
10-08-2023 08:00,1444,1368,South,60,1587,832,Furniture,76
10-08-2023 09:00,4641,2028,South,99,1762,938,Clothing,2613
10-08-2023 10:00,1362,1500,North,61,782,263,Electronics,-138
10-08-2023 11:00,3170,1273,East,52,1965,779,Electronics,1897
10-08-2023 12:00,2211,2791,South,70,1823,481,Clothing,-580
10-08-2023 13:00,1741,2929,North,63,592,830,Furniture,-1188
10-08-2023 14:00,3041,1626,West,64,1898,681,Groceries,1415
10-08-2023 15:00,1679,1560,West,91,1185,521,Clothing,119
10-08-2023 16:00,3467,2177,North,90,809,537,Furniture,1290
10-08-2023 17:00,4697,2043,South,59,1387,871,Groceries,2654
10-08-2023 18:00,4323,896,East,85,1690,162,Clothing,3427
10-08-2023 19:00,2642,2843,North,59,506,345,Clothing,-201
10-08-2023 20:00,2572,606,South,66,1566,149,Furniture,1966
10-08-2023 21:00,2358,1453,North,93,1287,897,Clothing,905
10-08-2023 22:00,3139,2348,South,74,1863,333,Electronics,791
10-08-2023 23:00,4601,1433,West,76,1676,627,Electronics,3168
11-08-2023 00:00,4937,787,North,82,542,615,Groceries,4150
11-08-2023 01:00,1062,1205,East,60,1224,381,Clothing,-143
11-08-2023 02:00,4733,2543,North,62,700,768,Electronics,2190
11-08-2023 03:00,3559,1984,West,50,1394,319,Furniture,1575
11-08-2023 04:00,2162,714,West,80,1166,447,Furniture,1448
11-08-2023 05:00,4769,1804,South,82,1047,463,Furniture,2965
11-08-2023 06:00,4256,2477,West,70,725,662,Electronics,1779
11-08-2023 07:00,2228,1982,South,65,1132,141,Clothing,246
11-08-2023 08:00,3819,2324,West,88,1862,522,Clothing,1495
11-08-2023 09:00,4285,843,South,72,1858,234,Clothing,3442
11-08-2023 10:00,1255,693,East,59,1704,885,Groceries,562
11-08-2023 11:00,1134,657,South,97,1445,358,Clothing,477
11-08-2023 12:00,4644,964,South,82,1795,290,Electronics,3680
11-08-2023 13:00,1874,2651,East,71,693,355,Electronics,-777
11-08-2023 14:00,1821,2581,South,90,1037,847,Clothing,-760
11-08-2023 15:00,3135,2249,South,55,980,593,Furniture,886
11-08-2023 16:00,4907,2872,East,96,1621,887,Groceries,2035
11-08-2023 17:00,4035,1091,West,85,929,965,Groceries,2944
11-08-2023 18:00,4278,2688,North,96,1850,172,Electronics,1590
11-08-2023 19:00,4200,1554,South,59,1444,173,Groceries,2646
11-08-2023 20:00,1822,1383,West,65,1410,734,Furniture,439
11-08-2023 21:00,4074,562,North,62,1077,681,Clothing,3512
11-08-2023 22:00,1973,1610,East,69,1939,500,Groceries,363
11-08-2023 23:00,3981,803,South,53,610,178,Groceries,3178
12-08-2023 00:00,2777,1584,South,69,711,347,Electronics,1193
12-08-2023 01:00,1120,895,East,71,1350,286,Furniture,225
12-08-2023 02:00,4456,833,South,78,1377,752,Electronics,3623
12-08-2023 03:00,2637,910,North,65,1486,909,Electronics,1727
12-08-2023 04:00,4109,2831,North,92,1495,655,Groceries,1278
12-08-2023 05:00,2364,965,East,96,1070,858,Electronics,1399
12-08-2023 06:00,2007,579,South,92,1553,569,Electronics,1428
12-08-2023 07:00,1924,1600,West,72,1790,947,Groceries,324
12-08-2023 08:00,1644,2477,South,79,1165,837,Groceries,-833
12-08-2023 09:00,3032,1232,East,79,849,678,Groceries,1800
12-08-2023 10:00,3761,2317,West,92,1429,555,Clothing,1444
12-08-2023 11:00,3907,2063,North,52,1180,375,Furniture,1844
12-08-2023 12:00,3068,1884,North,73,1737,864,Clothing,1184
12-08-2023 13:00,1241,2624,West,98,750,914,Groceries,-1383
12-08-2023 14:00,3502,1687,West,86,818,891,Furniture,1815
12-08-2023 15:00,4010,1698,East,62,1706,278,Electronics,2312
12-08-2023 16:00,3668,2111,South,91,1384,890,Furniture,1557
12-08-2023 17:00,3350,2792,North,81,688,228,Groceries,558
12-08-2023 18:00,2619,621,South,86,1224,478,Clothing,1998
12-08-2023 19:00,4666,684,North,61,1650,214,Furniture,3982
12-08-2023 20:00,1802,531,South,57,1819,421,Electronics,1271
12-08-2023 21:00,1963,1497,North,73,1546,488,Clothing,466
12-08-2023 22:00,1068,2486,South,93,578,885,Clothing,-1418
12-08-2023 23:00,2152,1068,East,65,1045,563,Clothing,1084
13-08-2023 00:00,1195,2857,North,81,1993,301,Clothing,-1662
13-08-2023 01:00,3187,1895,East,83,1423,728,Electronics,1292
13-08-2023 02:00,4515,2179,North,84,1118,646,Groceries,2336
13-08-2023 03:00,3330,1329,North,81,804,508,Electronics,2001
13-08-2023 04:00,3359,2119,North,99,1971,717,Groceries,1240
13-08-2023 05:00,1745,1579,South,66,698,860,Groceries,166
13-08-2023 06:00,4606,1290,North,51,1714,251,Furniture,3316
13-08-2023 07:00,2688,1493,East,75,1755,752,Electronics,1195
13-08-2023 08:00,1276,577,South,93,1053,504,Groceries,699
13-08-2023 09:00,1060,607,South,66,1547,590,Electronics,453
13-08-2023 10:00,4390,1796,North,87,1984,906,Electronics,2594
13-08-2023 11:00,2913,2562,West,98,682,261,Groceries,351
13-08-2023 12:00,3099,869,South,51,1956,246,Groceries,2230
13-08-2023 13:00,4927,2752,North,57,1106,511,Clothing,2175
13-08-2023 14:00,3200,2504,East,95,582,355,Furniture,696
13-08-2023 15:00,2772,2203,West,55,592,702,Groceries,569
13-08-2023 16:00,2334,940,South,58,1801,469,Groceries,1394
13-08-2023 17:00,2837,726,West,50,1116,829,Groceries,2111
13-08-2023 18:00,3591,2901,South,54,1608,750,Furniture,690
13-08-2023 19:00,1566,1122,West,88,1072,788,Electronics,444
13-08-2023 20:00,4935,1524,West,58,1731,390,Clothing,3411
13-08-2023 21:00,4460,2076,East,63,1080,439,Clothing,2384
13-08-2023 22:00,2571,2143,West,76,1500,175,Electronics,428
13-08-2023 23:00,1621,1684,East,58,1967,668,Furniture,-63
14-08-2023 00:00,3025,660,North,85,1273,639,Furniture,2365
14-08-2023 01:00,2200,1370,South,78,1352,933,Groceries,830
14-08-2023 02:00,4433,2245,East,69,1893,604,Furniture,2188
14-08-2023 03:00,1313,1674,South,64,1150,420,Furniture,-361
14-08-2023 04:00,3854,943,East,85,1291,761,Groceries,2911
14-08-2023 05:00,3895,2290,South,52,975,406,Electronics,1605
14-08-2023 06:00,3144,1994,East,72,1003,446,Clothing,1150
14-08-2023 07:00,3928,962,South,95,730,492,Electronics,2966
14-08-2023 08:00,2236,972,North,58,1377,298,Electronics,1264
14-08-2023 09:00,3876,579,South,79,1883,775,Groceries,3297
14-08-2023 10:00,1136,1562,North,68,1542,281,Electronics,-426
14-08-2023 11:00,2029,739,North,87,1189,339,Furniture,1290
14-08-2023 12:00,4058,1056,North,52,708,853,Electronics,3002
14-08-2023 13:00,3156,1089,West,99,630,165,Electronics,2067
14-08-2023 14:00,3594,1860,South,97,1242,270,Groceries,1734
14-08-2023 15:00,4110,2384,West,52,883,744,Groceries,1726
14-08-2023 16:00,1661,2475,West,83,1615,692,Clothing,-814
14-08-2023 17:00,3472,1803,South,51,861,264,Furniture,1669
14-08-2023 18:00,3677,1639,North,76,1260,162,Furniture,2038
14-08-2023 19:00,3308,2816,West,72,1647,454,Clothing,492
14-08-2023 20:00,4497,2439,West,91,1442,150,Clothing,2058
14-08-2023 21:00,1086,834,East,81,1147,683,Groceries,252
14-08-2023 22:00,3512,811,South,96,1796,142,Clothing,2701
14-08-2023 23:00,3123,1576,West,84,854,934,Electronics,1547
15-08-2023 00:00,3518,533,South,89,599,420,Clothing,2985
15-08-2023 01:00,3461,2341,South,67,1230,417,Electronics,1120
15-08-2023 02:00,3872,885,West,76,800,315,Clothing,2987
15-08-2023 03:00,3942,748,South,60,1108,290,Groceries,3194
15-08-2023 04:00,3773,1634,North,88,1381,769,Furniture,2139
15-08-2023 05:00,3504,1933,West,68,702,589,Electronics,1571
15-08-2023 06:00,2308,1702,West,74,1544,189,Furniture,606
15-08-2023 07:00,4310,1293,West,56,1721,521,Electronics,3017
15-08-2023 08:00,2700,1351,East,80,611,590,Furniture,1349
15-08-2023 09:00,4670,875,East,51,1672,715,Groceries,3795
15-08-2023 10:00,3700,1223,East,87,880,662,Electronics,2477
15-08-2023 11:00,3719,2110,East,54,1254,353,Clothing,1609
15-08-2023 12:00,4629,2413,West,63,1453,206,Groceries,2216
15-08-2023 13:00,4443,701,North,67,1706,393,Furniture,3742
15-08-2023 14:00,1494,2992,South,85,1295,610,Electronics,-1498
15-08-2023 15:00,2647,2442,South,53,836,335,Groceries,205
15-08-2023 16:00,2942,2844,West,73,1861,597,Furniture,98
15-08-2023 17:00,2068,1831,North,62,1823,934,Electronics,237
15-08-2023 18:00,2424,992,South,70,721,944,Electronics,1432
15-08-2023 19:00,4318,837,North,82,1511,455,Groceries,3481
15-08-2023 20:00,4687,2468,West,69,1259,716,Furniture,2219
15-08-2023 21:00,1596,2365,East,54,1932,866,Furniture,-769
15-08-2023 22:00,1449,1291,North,73,1188,403,Electronics,158
15-08-2023 23:00,1484,2016,South,84,617,631,Furniture,-532
16-08-2023 00:00,1645,2522,South,79,673,970,Clothing,-877
16-08-2023 01:00,3667,2864,South,77,1742,591,Clothing,803
16-08-2023 02:00,4089,1441,East,94,1899,683,Electronics,2648
16-08-2023 03:00,2629,2622,North,56,818,216,Furniture,7
16-08-2023 04:00,1661,558,North,91,1611,466,Electronics,1103
16-08-2023 05:00,1757,2933,South,84,1601,741,Clothing,-1176
16-08-2023 06:00,1288,2562,North,79,940,558,Electronics,-1274
16-08-2023 07:00,4485,1754,South,83,1724,219,Electronics,2731
16-08-2023 08:00,1720,2746,North,88,914,312,Groceries,-1026
16-08-2023 09:00,1637,1877,East,58,1527,840,Groceries,-240
16-08-2023 10:00,3282,534,East,61,1449,282,Clothing,2748
16-08-2023 11:00,3463,661,West,78,582,745,Furniture,2802
16-08-2023 12:00,3985,1394,West,59,1488,438,Clothing,2591
16-08-2023 13:00,1498,970,West,76,992,577,Furniture,528
16-08-2023 14:00,4021,1946,North,68,505,593,Furniture,2075
16-08-2023 15:00,1633,847,East,62,1204,330,Groceries,786
16-08-2023 16:00,2673,1193,East,91,846,995,Groceries,1480
16-08-2023 17:00,3030,1434,East,86,1033,463,Clothing,1596
16-08-2023 18:00,4067,1412,South,81,1156,545,Clothing,2655
16-08-2023 19:00,1114,646,North,64,1454,583,Clothing,468
16-08-2023 20:00,3979,2211,North,70,950,951,Groceries,1768
16-08-2023 21:00,1673,1174,West,52,1668,345,Groceries,499
16-08-2023 22:00,2736,1939,South,57,1525,863,Electronics,797
16-08-2023 23:00,2257,2017,South,55,1811,324,Clothing,240
17-08-2023 00:00,4611,1779,East,78,1417,256,Electronics,2832
17-08-2023 01:00,4082,1185,West,68,1748,730,Furniture,2897
17-08-2023 02:00,3253,1626,North,66,1453,705,Clothing,1627
17-08-2023 03:00,4750,620,South,59,1960,839,Groceries,4130
17-08-2023 04:00,3294,2966,East,82,713,464,Clothing,328
17-08-2023 05:00,4630,2897,North,62,1399,285,Clothing,1733
17-08-2023 06:00,3805,541,East,76,1689,594,Groceries,3264
17-08-2023 07:00,4198,528,North,91,872,945,Groceries,3670
17-08-2023 08:00,1146,1465,East,61,1152,284,Furniture,-319
17-08-2023 09:00,3165,2415,North,51,1006,486,Clothing,750
17-08-2023 10:00,4982,2500,West,59,1482,379,Clothing,2482
17-08-2023 11:00,4453,2561,North,70,1075,841,Clothing,1892
17-08-2023 12:00,1411,1419,North,72,832,581,Clothing,-8
17-08-2023 13:00,2687,1317,North,50,711,364,Furniture,1370
17-08-2023 14:00,4655,2008,East,82,788,769,Clothing,2647
17-08-2023 15:00,3410,1712,South,75,1109,451,Furniture,1698
17-08-2023 16:00,2532,1371,North,64,665,688,Furniture,1161
17-08-2023 17:00,1136,794,North,71,625,181,Groceries,342
17-08-2023 18:00,4246,1363,West,74,1680,280,Clothing,2883
17-08-2023 19:00,4360,1537,North,50,1555,441,Groceries,2823
17-08-2023 20:00,4005,1094,West,75,773,295,Furniture,2911
17-08-2023 21:00,4552,1682,North,70,1824,159,Electronics,2870
17-08-2023 22:00,1018,2017,East,90,1544,250,Electronics,-999
17-08-2023 23:00,3242,1852,South,73,1114,160,Clothing,1390
18-08-2023 00:00,3377,1113,South,88,775,746,Electronics,2264
18-08-2023 01:00,2959,2372,South,65,1530,527,Groceries,587
18-08-2023 02:00,3222,2103,East,81,1515,430,Electronics,1119
18-08-2023 03:00,2001,2083,West,65,1978,138,Electronics,-82
18-08-2023 04:00,1448,2092,South,62,1653,352,Furniture,-644
18-08-2023 05:00,2948,1655,East,91,1822,989,Groceries,1293
18-08-2023 06:00,1945,964,East,81,596,717,Clothing,981
18-08-2023 07:00,2377,1979,North,99,776,332,Groceries,398
18-08-2023 08:00,2522,1790,West,90,1808,453,Groceries,732
18-08-2023 09:00,1140,2942,East,93,1299,269,Clothing,-1802
18-08-2023 10:00,3805,2793,West,73,1696,316,Groceries,1012
18-08-2023 11:00,2920,1067,South,62,831,447,Furniture,1853
18-08-2023 12:00,3977,537,South,60,704,625,Clothing,3440
18-08-2023 13:00,1092,744,South,64,602,510,Furniture,348
18-08-2023 14:00,1238,520,North,59,1503,627,Groceries,718
18-08-2023 15:00,1204,1633,North,91,1454,830,Electronics,-429
18-08-2023 16:00,3607,2129,West,90,859,997,Clothing,1478
18-08-2023 17:00,2456,893,West,52,1654,780,Clothing,1563
18-08-2023 18:00,1244,1933,North,65,538,625,Electronics,-689
18-08-2023 19:00,1831,1486,East,93,806,342,Electronics,345
18-08-2023 20:00,4388,2171,West,66,1383,930,Clothing,2217
18-08-2023 21:00,3972,2555,West,74,1019,107,Electronics,1417
18-08-2023 22:00,1294,2875,South,79,1377,382,Furniture,-1581
18-08-2023 23:00,3687,2410,West,96,545,722,Groceries,1277
19-08-2023 00:00,1855,789,West,84,693,651,Furniture,1066
19-08-2023 01:00,4353,2286,East,86,1692,679,Groceries,2067
19-08-2023 02:00,3064,1411,West,62,1645,734,Groceries,1653
19-08-2023 03:00,1070,860,East,73,748,928,Electronics,210
19-08-2023 04:00,2292,2122,South,87,1512,265,Electronics,170
19-08-2023 05:00,2348,718,North,75,706,302,Furniture,1630
19-08-2023 06:00,4865,2953,South,58,614,739,Electronics,1912
19-08-2023 07:00,1304,2515,East,68,738,463,Furniture,-1211
19-08-2023 08:00,4522,2540,East,77,1065,251,Clothing,1982
19-08-2023 09:00,2030,2544,West,56,1599,524,Furniture,-514
19-08-2023 10:00,2337,1331,West,94,1692,757,Groceries,1006
19-08-2023 11:00,1816,2293,North,71,1571,660,Clothing,-477
19-08-2023 12:00,2126,2291,East,79,1235,568,Furniture,-165
19-08-2023 13:00,1820,1743,East,86,1593,509,Furniture,77
19-08-2023 14:00,1192,1094,South,65,1007,614,Clothing,98
19-08-2023 15:00,2776,2654,North,85,654,350,Clothing,122
19-08-2023 16:00,4645,1080,South,54,960,176,Groceries,3565
19-08-2023 17:00,1528,2247,West,78,1896,521,Groceries,-719
19-08-2023 18:00,3218,2555,West,72,1290,831,Groceries,663
19-08-2023 19:00,4608,2736,South,55,1725,484,Electronics,1872
19-08-2023 20:00,1250,580,West,85,1153,959,Groceries,670
19-08-2023 21:00,2788,2655,South,82,816,478,Electronics,133
19-08-2023 22:00,4458,1844,East,98,950,327,Furniture,2614
19-08-2023 23:00,4278,2102,East,90,1076,217,Furniture,2176
20-08-2023 00:00,3588,845,West,65,1619,366,Furniture,2743
20-08-2023 01:00,4700,2386,North,83,995,334,Electronics,2314
20-08-2023 02:00,3026,2875,East,92,861,267,Furniture,151
20-08-2023 03:00,3463,1054,West,75,956,871,Furniture,2409
20-08-2023 04:00,3841,801,North,86,1701,804,Electronics,3040
20-08-2023 05:00,2403,699,West,62,628,795,Groceries,1704
20-08-2023 06:00,2167,1562,South,66,1562,621,Groceries,605
20-08-2023 07:00,3072,806,West,81,1981,436,Groceries,2266
20-08-2023 08:00,4893,2156,South,81,1311,426,Groceries,2737
20-08-2023 09:00,3715,2371,East,77,1372,458,Clothing,1344
20-08-2023 10:00,2096,2726,East,78,849,547,Furniture,-630
20-08-2023 11:00,3679,2346,West,74,1144,752,Groceries,1333
20-08-2023 12:00,2847,2264,North,96,951,633,Groceries,583
20-08-2023 13:00,4904,775,West,71,1903,923,Groceries,4129
20-08-2023 14:00,4164,1675,West,76,608,989,Groceries,2489
20-08-2023 15:00,1504,1901,East,93,1731,804,Groceries,-397
20-08-2023 16:00,2621,1137,East,87,1076,703,Clothing,1484
20-08-2023 17:00,3383,2275,West,69,740,196,Clothing,1108
20-08-2023 18:00,3472,1429,East,94,1090,752,Electronics,2043
20-08-2023 19:00,3546,2380,South,99,1611,868,Electronics,1166
20-08-2023 20:00,2387,682,West,73,1922,649,Groceries,1705
20-08-2023 21:00,3994,2344,East,96,1785,858,Electronics,1650
20-08-2023 22:00,3677,571,West,96,1077,355,Clothing,3106
20-08-2023 23:00,4816,2176,East,57,824,541,Groceries,2640
21-08-2023 00:00,2222,1795,South,63,870,508,Electronics,427
21-08-2023 01:00,1717,2816,South,88,604,909,Electronics,-1099
21-08-2023 02:00,4484,1543,West,63,597,184,Clothing,2941
21-08-2023 03:00,1338,1314,South,54,595,516,Furniture,24
21-08-2023 04:00,1658,2026,South,96,1995,648,Groceries,-368
21-08-2023 05:00,1961,2694,East,70,545,601,Electronics,-733
21-08-2023 06:00,1428,809,West,64,1389,796,Clothing,619
21-08-2023 07:00,4854,2561,East,85,530,197,Groceries,2293
21-08-2023 08:00,1898,631,East,82,907,929,Clothing,1267
21-08-2023 09:00,1138,2377,North,66,1898,998,Groceries,-1239
21-08-2023 10:00,4764,2986,South,69,1905,641,Furniture,1778
21-08-2023 11:00,3989,1239,East,50,1215,602,Furniture,2750
21-08-2023 12:00,1541,1294,East,65,1143,550,Groceries,247
21-08-2023 13:00,3104,2810,East,94,1197,290,Groceries,294
21-08-2023 14:00,2255,757,South,67,1472,949,Clothing,1498
21-08-2023 15:00,3705,1757,South,59,1200,890,Groceries,1948
21-08-2023 16:00,3482,2956,South,72,1375,300,Electronics,526
21-08-2023 17:00,1383,2351,West,67,1405,421,Groceries,-968
21-08-2023 18:00,3607,1474,East,98,1308,800,Groceries,2133
21-08-2023 19:00,1193,1547,South,58,1832,357,Furniture,-354
21-08-2023 20:00,4807,770,East,95,1098,254,Furniture,4037
21-08-2023 21:00,4719,1618,West,79,1466,586,Clothing,3101
21-08-2023 22:00,3581,641,North,62,1132,930,Groceries,2940
21-08-2023 23:00,3565,1401,West,80,634,327,Electronics,2164
22-08-2023 00:00,3763,773,South,95,827,616,Electronics,2990
22-08-2023 01:00,3798,2823,South,92,698,740,Groceries,975
22-08-2023 02:00,3232,964,West,62,1182,610,Clothing,2268
22-08-2023 03:00,2895,1731,East,81,1783,173,Electronics,1164
22-08-2023 04:00,3339,1819,South,66,623,464,Clothing,1520
22-08-2023 05:00,4406,787,South,52,1253,123,Groceries,3619
22-08-2023 06:00,1731,1375,West,50,881,926,Clothing,356
22-08-2023 07:00,3163,2492,East,54,1070,562,Groceries,671
22-08-2023 08:00,3872,2727,West,81,1632,580,Furniture,1145
22-08-2023 09:00,4120,1620,West,74,1564,890,Groceries,2500
22-08-2023 10:00,1684,1714,East,94,1968,817,Clothing,-30
22-08-2023 11:00,1081,946,East,54,1297,757,Electronics,135
22-08-2023 12:00,3881,1221,North,86,1390,188,Groceries,2660
22-08-2023 13:00,3380,2663,West,72,1669,633,Groceries,717
22-08-2023 14:00,3604,1851,East,61,675,399,Groceries,1753
22-08-2023 15:00,3382,906,South,83,1802,143,Furniture,2476
22-08-2023 16:00,1531,2225,North,72,879,136,Furniture,-694
22-08-2023 17:00,2983,1193,West,65,664,618,Furniture,1790
22-08-2023 18:00,1220,994,East,98,1263,573,Electronics,226
22-08-2023 19:00,1634,1447,North,54,1114,379,Electronics,187
22-08-2023 20:00,2769,522,North,93,1884,560,Groceries,2247
22-08-2023 21:00,4804,1628,South,96,672,268,Electronics,3176
22-08-2023 22:00,3370,2198,North,77,1262,169,Clothing,1172
22-08-2023 23:00,2874,1057,West,55,1700,312,Clothing,1817
23-08-2023 00:00,1002,2116,East,62,1572,682,Furniture,-1114
23-08-2023 01:00,2717,1440,North,92,1634,818,Clothing,1277
23-08-2023 02:00,1205,1745,North,79,1733,171,Clothing,-540
23-08-2023 03:00,2855,2156,West,75,1118,927,Groceries,699
23-08-2023 04:00,1039,577,South,66,1164,279,Furniture,462
23-08-2023 05:00,3106,1845,South,58,1358,307,Furniture,1261
23-08-2023 06:00,3998,1306,East,65,1678,276,Furniture,2692
23-08-2023 07:00,3621,1541,West,98,1796,806,Clothing,2080
23-08-2023 08:00,1643,1267,South,67,1055,400,Electronics,376
23-08-2023 09:00,2530,953,East,62,1136,983,Groceries,1577
23-08-2023 10:00,4643,2824,East,78,1978,850,Electronics,1819
23-08-2023 11:00,2907,1947,South,92,1839,253,Furniture,960
23-08-2023 12:00,3890,1999,West,94,714,253,Furniture,1891
23-08-2023 13:00,4193,1550,North,73,1853,129,Clothing,2643
23-08-2023 14:00,4550,2388,South,94,643,126,Groceries,2162
23-08-2023 15:00,3666,862,North,93,1118,339,Groceries,2804
23-08-2023 16:00,3143,1024,North,95,1507,854,Groceries,2119
23-08-2023 17:00,4930,1717,West,62,853,743,Clothing,3213
23-08-2023 18:00,4485,1985,West,74,780,790,Electronics,2500
23-08-2023 19:00,4306,2603,East,90,1845,950,Groceries,1703
23-08-2023 20:00,1897,1753,West,95,1829,197,Electronics,144
23-08-2023 21:00,2085,2355,East,50,1336,425,Clothing,-270
23-08-2023 22:00,2279,1221,South,58,889,336,Clothing,1058
23-08-2023 23:00,3608,2483,North,53,1587,946,Electronics,1125
24-08-2023 00:00,3952,1707,West,77,764,237,Groceries,2245
24-08-2023 01:00,3395,1948,South,61,505,729,Electronics,1447
24-08-2023 02:00,1670,1898,East,73,1412,717,Groceries,-228
24-08-2023 03:00,4195,2588,West,95,667,647,Furniture,1607
24-08-2023 04:00,2505,2007,North,58,854,145,Furniture,498
24-08-2023 05:00,3364,1503,South,84,672,715,Groceries,1861
24-08-2023 06:00,4575,2807,West,87,1349,489,Electronics,1768
24-08-2023 07:00,1718,2988,West,84,618,463,Groceries,-1270
24-08-2023 08:00,2071,1425,South,82,1749,459,Groceries,646
24-08-2023 09:00,4480,1355,East,84,673,681,Groceries,3125
24-08-2023 10:00,2955,583,East,95,1458,306,Furniture,2372
24-08-2023 11:00,2159,2593,West,69,628,832,Clothing,-434
24-08-2023 12:00,4272,2987,East,51,686,700,Furniture,1285
24-08-2023 13:00,1249,2042,East,93,1586,614,Groceries,-793
24-08-2023 14:00,3361,1485,South,75,1392,909,Electronics,1876
24-08-2023 15:00,2892,2368,East,91,1797,465,Clothing,524
24-08-2023 16:00,4439,635,East,62,1097,537,Groceries,3804
24-08-2023 17:00,4500,1706,South,79,709,330,Clothing,2794
24-08-2023 18:00,2853,2232,West,81,1508,522,Electronics,621
24-08-2023 19:00,3854,1695,West,85,1716,568,Clothing,2159
24-08-2023 20:00,2503,1408,South,68,1249,729,Clothing,1095
24-08-2023 21:00,4385,1089,North,71,1031,410,Groceries,3296
24-08-2023 22:00,4571,2451,South,50,1451,494,Electronics,2120
24-08-2023 23:00,4792,1455,North,60,1705,213,Electronics,3337
25-08-2023 00:00,4426,1643,East,75,1059,301,Furniture,2783
25-08-2023 01:00,3532,1831,West,97,727,562,Clothing,1701
25-08-2023 02:00,2234,2053,North,68,1065,641,Groceries,181
25-08-2023 03:00,4775,2842,North,68,1113,463,Clothing,1933
25-08-2023 04:00,1043,2306,East,61,588,346,Clothing,-1263
25-08-2023 05:00,4612,2600,West,52,1667,692,Clothing,2012
25-08-2023 06:00,3618,1305,East,67,1314,345,Groceries,2313
25-08-2023 07:00,1582,1955,West,98,749,283,Clothing,-373
25-08-2023 08:00,4163,551,West,54,724,512,Groceries,3612
25-08-2023 09:00,2288,571,East,97,1402,372,Electronics,1717
25-08-2023 10:00,3942,527,North,73,1470,644,Clothing,3415
25-08-2023 11:00,1219,968,South,63,1172,713,Furniture,251
25-08-2023 12:00,2925,1263,West,87,667,376,Electronics,1662
25-08-2023 13:00,3972,1924,West,52,609,722,Furniture,2048
25-08-2023 14:00,4513,2748,South,55,1696,598,Clothing,1765
25-08-2023 15:00,3448,1319,South,61,796,817,Electronics,2129
25-08-2023 16:00,4471,1989,East,60,742,877,Groceries,2482
25-08-2023 17:00,3774,2175,West,88,708,589,Clothing,1599
25-08-2023 18:00,1990,1059,East,75,1766,314,Clothing,931
25-08-2023 19:00,3946,878,South,50,1777,202,Groceries,3068
25-08-2023 20:00,2812,2418,East,65,1605,906,Furniture,394
25-08-2023 21:00,4647,1575,West,97,1957,689,Electronics,3072
25-08-2023 22:00,1857,578,North,98,1998,274,Electronics,1279
25-08-2023 23:00,1803,1908,North,96,1527,953,Groceries,-105
26-08-2023 00:00,1489,1333,West,58,1717,151,Electronics,156
26-08-2023 01:00,4556,1531,East,54,1579,396,Groceries,3025
26-08-2023 02:00,2780,2572,South,57,760,274,Furniture,208
26-08-2023 03:00,2493,949,South,70,879,442,Furniture,1544
26-08-2023 04:00,4645,2492,North,82,595,810,Electronics,2153
26-08-2023 05:00,3985,1984,East,88,1859,699,Groceries,2001
26-08-2023 06:00,3891,2745,South,92,1268,270,Groceries,1146
26-08-2023 07:00,2705,2242,South,69,1852,136,Groceries,463
26-08-2023 08:00,4516,2470,West,94,1328,734,Groceries,2046
26-08-2023 09:00,4340,2984,East,71,1425,300,Electronics,1356
26-08-2023 10:00,3314,2050,East,62,1648,163,Clothing,1264
26-08-2023 11:00,1053,1189,South,88,1119,585,Electronics,-136
26-08-2023 12:00,3575,2490,East,60,759,554,Groceries,1085
26-08-2023 13:00,4591,1901,East,67,1330,799,Clothing,2690
26-08-2023 14:00,1615,1086,East,79,1049,826,Clothing,529
26-08-2023 15:00,2082,2651,West,82,1199,508,Electronics,-569
26-08-2023 16:00,2848,2329,South,93,1208,986,Groceries,519
26-08-2023 17:00,4111,2485,North,52,1531,854,Groceries,1626
26-08-2023 18:00,4308,1126,East,50,1062,249,Groceries,3182
26-08-2023 19:00,1954,2531,South,85,872,601,Groceries,-577
26-08-2023 20:00,3433,863,North,55,721,735,Groceries,2570
26-08-2023 21:00,2629,2682,West,86,1030,809,Clothing,-53
26-08-2023 22:00,3781,873,South,78,849,647,Electronics,2908
26-08-2023 23:00,3763,2586,West,60,530,913,Electronics,1177
27-08-2023 00:00,1649,2487,South,62,1881,377,Furniture,-838
27-08-2023 01:00,3347,2594,West,60,521,134,Electronics,753
27-08-2023 02:00,1394,2583,South,87,1812,724,Clothing,-1189
27-08-2023 03:00,4278,2642,West,74,1253,274,Furniture,1636
27-08-2023 04:00,2359,1884,North,64,713,132,Clothing,475
27-08-2023 05:00,3640,2048,South,62,1211,824,Electronics,1592
27-08-2023 06:00,4801,1669,North,91,1688,814,Clothing,3132
27-08-2023 07:00,3561,2440,East,82,639,496,Clothing,1121
27-08-2023 08:00,4249,867,North,62,1893,353,Electronics,3382
27-08-2023 09:00,3443,564,South,87,1464,667,Clothing,2879
27-08-2023 10:00,1370,1253,North,73,1843,422,Furniture,117
27-08-2023 11:00,1857,2043,South,69,908,112,Furniture,-186
27-08-2023 12:00,1790,2535,West,93,937,149,Groceries,-745
27-08-2023 13:00,1657,2376,East,66,1296,859,Furniture,-719
27-08-2023 14:00,4389,2078,North,99,512,332,Furniture,2311
27-08-2023 15:00,3783,1255,East,73,1000,639,Electronics,2528
27-08-2023 16:00,2392,2728,North,75,1549,715,Furniture,-336
27-08-2023 17:00,1383,2024,South,89,1033,965,Electronics,-641
27-08-2023 18:00,3109,1096,North,81,1360,195,Furniture,2013
27-08-2023 19:00,4877,2334,East,78,575,442,Electronics,2543
27-08-2023 20:00,3552,1895,North,63,865,955,Electronics,1657
27-08-2023 21:00,1238,2086,East,86,1615,292,Clothing,-848
27-08-2023 22:00,1194,611,East,71,1340,610,Furniture,583
27-08-2023 23:00,3725,952,South,83,1386,550,Electronics,2773
28-08-2023 00:00,4293,2686,West,76,1789,224,Furniture,1607
28-08-2023 01:00,3108,2371,West,77,998,180,Groceries,737
28-08-2023 02:00,2152,2778,North,71,1693,106,Clothing,-626
28-08-2023 03:00,4037,1762,East,92,1869,429,Clothing,2275
28-08-2023 04:00,3732,752,South,52,1751,182,Electronics,2980
28-08-2023 05:00,3015,2504,West,71,1198,635,Furniture,511
28-08-2023 06:00,1155,1959,South,97,1179,725,Clothing,-804
28-08-2023 07:00,4988,2442,South,70,702,626,Clothing,2546
28-08-2023 08:00,4449,1826,East,65,945,212,Clothing,2623
28-08-2023 09:00,4693,2619,North,58,1017,539,Electronics,2074
28-08-2023 10:00,4852,2357,East,62,631,989,Groceries,2495
28-08-2023 11:00,1922,2769,West,59,1768,953,Electronics,-847
28-08-2023 12:00,3915,1600,West,98,590,861,Groceries,2315
28-08-2023 13:00,3950,561,South,70,1649,756,Clothing,3389
28-08-2023 14:00,4861,1994,East,98,971,118,Groceries,2867
28-08-2023 15:00,2609,1680,East,91,1765,108,Electronics,929
28-08-2023 16:00,4046,1305,South,89,1001,931,Electronics,2741
28-08-2023 17:00,4508,2672,North,56,1260,284,Furniture,1836
28-08-2023 18:00,1974,2375,South,95,886,137,Furniture,-401
28-08-2023 19:00,2230,2708,South,71,1530,822,Electronics,-478
28-08-2023 20:00,3435,1040,West,67,1611,233,Furniture,2395
28-08-2023 21:00,4551,1125,East,70,1097,201,Clothing,3426
28-08-2023 22:00,2814,2114,West,99,1407,248,Groceries,700
28-08-2023 23:00,3934,605,South,63,1366,192,Electronics,3329
29-08-2023 00:00,1837,1654,East,59,1668,901,Electronics,183
29-08-2023 01:00,3007,2208,South,82,1974,239,Furniture,799
29-08-2023 02:00,2363,2408,South,58,1854,394,Electronics,-45
29-08-2023 03:00,4940,2549,North,67,1687,963,Furniture,2391
29-08-2023 04:00,3387,2780,West,62,1156,873,Clothing,607
29-08-2023 05:00,1203,868,West,66,841,692,Electronics,335
29-08-2023 06:00,1160,1774,South,72,1524,643,Clothing,-614
29-08-2023 07:00,4611,1445,North,74,1643,287,Clothing,3166
29-08-2023 08:00,1391,2727,South,65,963,235,Electronics,-1336
29-08-2023 09:00,1768,792,South,73,961,265,Furniture,976
29-08-2023 10:00,4748,1083,South,80,1572,576,Furniture,3665
29-08-2023 11:00,3622,2722,North,60,1318,246,Clothing,900
29-08-2023 12:00,3581,2670,East,72,1850,344,Furniture,911
29-08-2023 13:00,2093,2774,North,90,973,282,Furniture,-681
29-08-2023 14:00,3940,2991,South,88,1387,108,Clothing,949
29-08-2023 15:00,1404,2975,East,71,1438,535,Electronics,-1571
29-08-2023 16:00,1607,1264,South,82,867,255,Electronics,343
29-08-2023 17:00,4746,2612,North,90,1810,929,Groceries,2134
29-08-2023 18:00,2614,1804,North,91,1547,787,Electronics,810
29-08-2023 19:00,2540,1914,East,97,1222,213,Furniture,626
29-08-2023 20:00,3875,927,North,67,792,854,Groceries,2948
29-08-2023 21:00,4191,2514,South,63,1972,266,Groceries,1677
29-08-2023 22:00,2837,606,East,77,1586,587,Groceries,2231
29-08-2023 23:00,1689,1158,West,60,1067,536,Electronics,531
30-08-2023 00:00,4759,1682,South,73,1981,322,Groceries,3077
30-08-2023 01:00,3949,2812,West,85,1373,290,Groceries,1137
30-08-2023 02:00,2240,1725,East,68,1460,886,Groceries,515
30-08-2023 03:00,3103,654,East,62,1936,900,Electronics,2449
30-08-2023 04:00,1365,1395,South,82,1088,675,Electronics,-30
30-08-2023 05:00,2722,2021,North,68,759,893,Electronics,701
30-08-2023 06:00,4575,2120,South,96,1407,272,Electronics,2455
30-08-2023 07:00,4815,1492,North,81,683,356,Clothing,3323
30-08-2023 08:00,4838,2792,North,64,1571,814,Electronics,2046
30-08-2023 09:00,4996,1823,South,60,646,549,Furniture,3173
30-08-2023 10:00,1454,1885,East,72,1091,600,Groceries,-431
30-08-2023 11:00,1103,2933,South,54,1932,176,Electronics,-1830
30-08-2023 12:00,1076,2961,West,71,1517,714,Furniture,-1885
30-08-2023 13:00,1229,1801,East,91,939,325,Furniture,-572
30-08-2023 14:00,2937,1258,North,67,1981,325,Furniture,1679
30-08-2023 15:00,4329,1246,East,56,728,838,Clothing,3083
30-08-2023 16:00,4335,1092,South,82,1807,707,Clothing,3243
30-08-2023 17:00,3378,2048,East,52,1231,175,Clothing,1330
30-08-2023 18:00,2205,515,North,77,1868,132,Furniture,1690
30-08-2023 19:00,1892,1492,North,50,1446,693,Electronics,400
30-08-2023 20:00,4839,1568,East,98,1787,168,Furniture,3271
30-08-2023 21:00,2573,1844,West,96,1239,950,Clothing,729
30-08-2023 22:00,3735,2695,North,86,877,514,Clothing,1040
30-08-2023 23:00,3074,2902,West,71,1626,830,Clothing,172
31-08-2023 00:00,4347,1202,North,97,1453,547,Electronics,3145
31-08-2023 01:00,2675,1112,East,93,1099,461,Furniture,1563
31-08-2023 02:00,1298,604,North,68,522,969,Clothing,694
31-08-2023 03:00,1956,1997,West,63,792,469,Furniture,-41
31-08-2023 04:00,3846,895,West,52,1790,498,Furniture,2951
31-08-2023 05:00,2114,2510,East,68,975,913,Clothing,-396
31-08-2023 06:00,3527,1350,West,82,1451,219,Groceries,2177
31-08-2023 07:00,3620,2488,West,70,950,147,Groceries,1132
31-08-2023 08:00,3505,941,East,50,1397,167,Groceries,2564
31-08-2023 09:00,2474,2168,North,75,784,438,Clothing,306
31-08-2023 10:00,1364,1372,East,59,1836,184,Furniture,-8
31-08-2023 11:00,3906,1166,North,84,1685,993,Groceries,2740
31-08-2023 12:00,2698,1551,North,62,1089,476,Electronics,1147
31-08-2023 13:00,1350,1127,North,55,621,484,Groceries,223
31-08-2023 14:00,4726,1928,South,92,1635,375,Electronics,2798
31-08-2023 15:00,4471,847,North,55,1762,867,Groceries,3624
31-08-2023 16:00,3300,1763,East,84,1733,304,Groceries,1537
31-08-2023 17:00,3828,1517,East,65,1872,844,Groceries,2311
31-08-2023 18:00,2904,1069,East,90,1010,164,Electronics,1835
31-08-2023 19:00,3850,2573,South,57,501,928,Electronics,1277
31-08-2023 20:00,2011,2452,West,52,1391,178,Groceries,-441
31-08-2023 21:00,3506,2764,South,54,1298,625,Electronics,742
31-08-2023 22:00,4770,1851,East,70,1128,424,Furniture,2919
31-08-2023 23:00,3964,1169,East,80,960,477,Groceries,2795
01-09-2023 00:00,1498,1217,West,63,1451,916,Furniture,281
01-09-2023 01:00,1949,2857,South,86,1471,780,Clothing,-908
01-09-2023 02:00,2994,766,East,68,1764,770,Clothing,2228
01-09-2023 03:00,4997,1938,North,86,1481,727,Clothing,3059
01-09-2023 04:00,3046,1856,North,69,1313,445,Furniture,1190
01-09-2023 05:00,1507,1522,East,51,553,803,Electronics,-15
01-09-2023 06:00,2327,2537,North,56,1990,956,Clothing,-210
01-09-2023 07:00,3548,2997,West,82,608,534,Groceries,551
01-09-2023 08:00,3850,1064,East,99,779,794,Groceries,2786
01-09-2023 09:00,3645,1770,South,91,1580,984,Electronics,1875
01-09-2023 10:00,1165,1559,East,55,1339,477,Groceries,-394
01-09-2023 11:00,4486,1924,West,56,1336,842,Furniture,2562
01-09-2023 12:00,3509,527,South,93,1737,779,Clothing,2982
01-09-2023 13:00,1919,719,West,67,1551,114,Furniture,1200
01-09-2023 14:00,1113,905,North,92,703,553,Groceries,208
01-09-2023 15:00,4504,2137,North,78,1044,292,Furniture,2367
01-09-2023 16:00,1991,2298,North,68,808,332,Electronics,-307
01-09-2023 17:00,4427,2818,West,74,1027,362,Furniture,1609
01-09-2023 18:00,2951,2259,West,53,1866,545,Groceries,692
01-09-2023 19:00,4766,2174,East,62,1508,153,Groceries,2592
01-09-2023 20:00,3254,1291,South,81,1741,791,Clothing,1963
01-09-2023 21:00,4839,1462,South,76,1116,103,Furniture,3377
01-09-2023 22:00,2258,1809,West,83,1610,356,Electronics,449
01-09-2023 23:00,4513,1333,West,77,530,460,Clothing,3180
02-09-2023 00:00,4426,816,North,58,599,933,Groceries,3610
02-09-2023 01:00,1514,1820,West,57,1166,339,Furniture,-306
02-09-2023 02:00,2231,2885,North,70,1303,581,Electronics,-654
02-09-2023 03:00,1708,1830,West,95,1838,774,Groceries,-122
02-09-2023 04:00,4924,850,South,79,994,560,Groceries,4074
02-09-2023 05:00,4196,1010,East,78,970,948,Clothing,3186
02-09-2023 06:00,3185,991,West,58,1241,237,Groceries,2194
02-09-2023 07:00,1338,2431,North,62,1233,550,Electronics,-1093
02-09-2023 08:00,3584,2117,East,67,1497,423,Electronics,1467
02-09-2023 09:00,1067,2556,North,87,830,572,Clothing,-1489
02-09-2023 10:00,2596,2020,North,71,1717,840,Clothing,576
02-09-2023 11:00,2564,2083,East,80,1714,713,Electronics,481
02-09-2023 12:00,1382,2987,East,84,751,576,Clothing,-1605
02-09-2023 13:00,1018,2075,East,91,1524,292,Groceries,-1057
02-09-2023 14:00,3730,2261,West,91,1982,406,Electronics,1469
02-09-2023 15:00,4521,2491,East,59,1613,641,Clothing,2030
02-09-2023 16:00,3121,1768,West,58,1017,906,Electronics,1353
02-09-2023 17:00,1572,2580,South,80,1639,858,Groceries,-1008
02-09-2023 18:00,3986,1546,South,93,572,320,Clothing,2440
02-09-2023 19:00,4736,548,North,89,655,271,Electronics,4188
02-09-2023 20:00,2299,961,North,73,1222,259,Groceries,1338
02-09-2023 21:00,4119,835,West,90,568,271,Clothing,3284
02-09-2023 22:00,3258,1881,North,98,970,162,Electronics,1377
02-09-2023 23:00,3902,1645,South,57,991,672,Groceries,2257
03-09-2023 00:00,2943,858,West,99,799,164,Groceries,2085
03-09-2023 01:00,1650,2893,West,69,1667,268,Groceries,-1243
03-09-2023 02:00,2645,692,East,66,1729,180,Furniture,1953
03-09-2023 03:00,1993,1939,West,77,1417,858,Groceries,54
03-09-2023 04:00,3742,1900,North,55,1212,367,Groceries,1842
03-09-2023 05:00,3587,1255,South,91,1250,479,Clothing,2332
03-09-2023 06:00,4780,2184,North,82,906,869,Furniture,2596
03-09-2023 07:00,4262,1327,South,77,1438,172,Groceries,2935
03-09-2023 08:00,2338,1389,East,50,1079,431,Clothing,949
03-09-2023 09:00,1900,1152,South,90,1820,287,Clothing,748
03-09-2023 10:00,4634,2955,East,84,1081,124,Electronics,1679
03-09-2023 11:00,2684,2833,North,73,1298,327,Electronics,-149
03-09-2023 12:00,3827,2421,East,55,1028,217,Furniture,1406
03-09-2023 13:00,2585,1350,West,56,636,544,Clothing,1235
03-09-2023 14:00,2923,610,West,58,718,207,Groceries,2313
03-09-2023 15:00,2781,1119,South,86,1017,341,Groceries,1662
03-09-2023 16:00,2136,1292,North,65,1971,710,Clothing,844
03-09-2023 17:00,3217,2597,North,83,631,633,Furniture,620
03-09-2023 18:00,4539,1657,South,84,1886,580,Groceries,2882
03-09-2023 19:00,4749,1087,West,84,1867,602,Furniture,3662
03-09-2023 20:00,2944,1809,East,69,1541,597,Clothing,1135
03-09-2023 21:00,2037,2457,South,72,1939,155,Furniture,-420
03-09-2023 22:00,2738,2861,East,91,1059,248,Electronics,-123
03-09-2023 23:00,1287,796,East,84,1427,410,Furniture,491
04-09-2023 00:00,4978,2129,North,96,1676,651,Furniture,2849
04-09-2023 01:00,3236,1068,West,95,831,761,Groceries,2168
04-09-2023 02:00,3961,1687,East,72,818,220,Furniture,2274
04-09-2023 03:00,4226,1331,West,53,1722,871,Groceries,2895
04-09-2023 04:00,2590,1109,North,59,1479,125,Groceries,1481
04-09-2023 05:00,3741,515,South,92,1533,211,Electronics,3226
04-09-2023 06:00,2745,1869,South,60,1662,610,Groceries,876
04-09-2023 07:00,3935,571,North,89,666,980,Clothing,3364
04-09-2023 08:00,3518,769,North,58,646,122,Groceries,2749
04-09-2023 09:00,2098,786,East,89,1926,780,Clothing,1312
04-09-2023 10:00,3324,565,North,61,1438,925,Groceries,2759
04-09-2023 11:00,1939,1379,South,66,944,363,Clothing,560
04-09-2023 12:00,4716,567,West,81,569,215,Electronics,4149
04-09-2023 13:00,4414,1716,West,72,1851,579,Furniture,2698
04-09-2023 14:00,2448,1902,West,64,1332,406,Groceries,546
04-09-2023 15:00,1570,1473,West,77,1418,330,Electronics,97
04-09-2023 16:00,4582,1007,North,87,1115,800,Electronics,3575
04-09-2023 17:00,3904,1625,North,54,1752,591,Groceries,2279
04-09-2023 18:00,2000,1385,West,89,818,868,Groceries,615
04-09-2023 19:00,2205,2969,North,67,535,219,Clothing,-764
04-09-2023 20:00,3505,2487,East,70,754,385,Groceries,1018
04-09-2023 21:00,1917,1274,North,64,1836,884,Groceries,643
04-09-2023 22:00,2874,1425,East,52,1461,506,Clothing,1449
04-09-2023 23:00,1832,619,East,95,834,457,Clothing,1213
05-09-2023 00:00,4135,2438,North,75,1543,989,Groceries,1697
05-09-2023 01:00,3886,987,West,64,797,251,Groceries,2899
05-09-2023 02:00,4331,2625,East,94,1544,697,Groceries,1706
05-09-2023 03:00,3240,940,North,69,977,424,Furniture,2300
05-09-2023 04:00,2678,961,South,70,971,956,Furniture,1717
05-09-2023 05:00,1615,1111,West,75,1461,938,Electronics,504
05-09-2023 06:00,1405,1817,South,90,969,345,Electronics,-412
05-09-2023 07:00,2749,2159,East,72,1872,925,Groceries,590
05-09-2023 08:00,4825,1416,South,98,1266,414,Clothing,3409
05-09-2023 09:00,3990,505,North,74,1089,904,Groceries,3485
05-09-2023 10:00,3768,1180,West,53,1291,261,Groceries,2588
05-09-2023 11:00,1092,2818,East,59,885,711,Electronics,-1726
05-09-2023 12:00,3477,2143,North,71,1441,468,Groceries,1334
05-09-2023 13:00,1653,598,West,52,945,284,Groceries,1055
05-09-2023 14:00,4505,1025,East,68,598,375,Electronics,3480
05-09-2023 15:00,4475,2741,East,80,1154,628,Electronics,1734
05-09-2023 16:00,1433,1680,East,58,1578,535,Clothing,-247
05-09-2023 17:00,2135,2189,East,78,1526,359,Clothing,-54
05-09-2023 18:00,1374,1638,South,86,1855,344,Clothing,-264
05-09-2023 19:00,4130,895,South,95,1433,917,Furniture,3235
05-09-2023 20:00,2066,1269,South,56,1958,437,Furniture,797
05-09-2023 21:00,1206,2326,East,87,1742,149,Groceries,-1120
05-09-2023 22:00,1779,2045,South,73,1734,371,Clothing,-266
05-09-2023 23:00,2319,1182,West,57,1316,334,Electronics,1137
06-09-2023 00:00,2141,2056,East,83,1160,683,Clothing,85
06-09-2023 01:00,1531,514,West,75,731,928,Groceries,1017
06-09-2023 02:00,4293,2915,West,77,1099,655,Furniture,1378
06-09-2023 03:00,3213,1736,South,77,1419,405,Furniture,1477
06-09-2023 04:00,3690,504,East,95,1671,576,Groceries,3186
06-09-2023 05:00,4227,2778,South,56,1730,587,Clothing,1449
06-09-2023 06:00,4255,2408,South,52,859,179,Groceries,1847
06-09-2023 07:00,1089,1925,South,71,1942,385,Groceries,-836
06-09-2023 08:00,2117,2107,East,87,1940,660,Furniture,10
06-09-2023 09:00,1012,668,East,95,1371,197,Furniture,344
06-09-2023 10:00,4020,1291,South,93,1705,577,Furniture,2729
06-09-2023 11:00,2857,1499,West,67,1055,505,Groceries,1358
06-09-2023 12:00,1804,651,West,61,1733,636,Clothing,1153
06-09-2023 13:00,1944,2771,East,80,749,825,Groceries,-827
06-09-2023 14:00,3789,1003,North,88,1095,667,Clothing,2786
06-09-2023 15:00,2857,2073,South,54,638,354,Clothing,784
06-09-2023 16:00,4875,2591,South,93,1489,767,Groceries,2284
06-09-2023 17:00,4509,1003,North,90,1754,586,Clothing,3506
06-09-2023 18:00,4609,1342,East,78,1409,772,Clothing,3267
06-09-2023 19:00,2610,850,West,92,511,293,Groceries,1760
06-09-2023 20:00,3923,2570,East,85,1479,615,Furniture,1353
06-09-2023 21:00,2959,2159,West,63,772,563,Groceries,800
06-09-2023 22:00,4882,1097,West,93,987,879,Furniture,3785
06-09-2023 23:00,4221,1566,East,67,1613,603,Clothing,2655
07-09-2023 00:00,3707,539,South,56,1548,135,Furniture,3168
07-09-2023 01:00,4079,2850,South,72,1037,115,Furniture,1229
07-09-2023 02:00,2052,674,South,82,1484,988,Electronics,1378
07-09-2023 03:00,1295,1498,West,94,1583,748,Electronics,-203
07-09-2023 04:00,4033,1984,South,65,1694,689,Furniture,2049
07-09-2023 05:00,1925,1716,West,86,1087,922,Electronics,209
07-09-2023 06:00,4792,2791,South,74,1287,172,Furniture,2001
07-09-2023 07:00,1639,1335,East,58,1970,419,Electronics,304
07-09-2023 08:00,3387,2827,North,77,1420,344,Clothing,560
07-09-2023 09:00,1627,1559,West,58,1533,957,Groceries,68
07-09-2023 10:00,3486,1397,East,61,742,839,Electronics,2089
07-09-2023 11:00,2167,2063,West,67,1701,294,Groceries,104
07-09-2023 12:00,1941,1546,West,76,1297,857,Electronics,395
07-09-2023 13:00,1829,1431,East,75,756,188,Furniture,398
07-09-2023 14:00,2770,2638,South,75,809,871,Electronics,132
07-09-2023 15:00,3566,2937,West,59,1015,897,Electronics,629
07-09-2023 16:00,1975,1751,North,66,1738,238,Groceries,224
07-09-2023 17:00,4116,1725,North,81,1553,662,Groceries,2391
07-09-2023 18:00,1954,1873,East,73,1869,758,Electronics,81
07-09-2023 19:00,2262,1561,North,92,1588,853,Groceries,701
07-09-2023 20:00,1951,999,East,97,1135,496,Electronics,952
07-09-2023 21:00,1943,2222,East,57,1296,583,Furniture,-279
07-09-2023 22:00,3202,2615,West,79,1676,486,Furniture,587
07-09-2023 23:00,2204,2263,East,75,539,467,Clothing,-59
08-09-2023 00:00,4286,2670,East,73,1549,945,Groceries,1616
08-09-2023 01:00,3135,2208,South,76,1796,557,Electronics,927
08-09-2023 02:00,4327,835,West,64,1682,521,Furniture,3492
08-09-2023 03:00,2534,1676,North,77,1080,331,Clothing,858
08-09-2023 04:00,2096,1278,South,60,500,638,Clothing,818
08-09-2023 05:00,3978,1685,South,88,578,443,Electronics,2293
08-09-2023 06:00,1178,2433,West,51,1751,819,Clothing,-1255
08-09-2023 07:00,3259,1966,West,58,1850,237,Clothing,1293
08-09-2023 08:00,2828,2970,South,99,1119,473,Electronics,-142
08-09-2023 09:00,2257,2061,West,94,1000,536,Clothing,196
08-09-2023 10:00,1464,1438,West,72,1998,254,Clothing,26
08-09-2023 11:00,2774,1303,East,82,1878,618,Electronics,1471
08-09-2023 12:00,4294,2435,West,68,1647,214,Electronics,1859
08-09-2023 13:00,3678,1133,East,62,1477,191,Furniture,2545
08-09-2023 14:00,3872,1753,South,63,1947,445,Clothing,2119
08-09-2023 15:00,4335,1582,South,81,1775,693,Furniture,2753
08-09-2023 16:00,2230,2643,North,98,985,624,Furniture,-413
08-09-2023 17:00,3654,1785,West,71,977,683,Groceries,1869
08-09-2023 18:00,1884,853,South,69,832,190,Electronics,1031
08-09-2023 19:00,4805,1659,East,82,1755,799,Groceries,3146
08-09-2023 20:00,3413,2385,South,54,529,497,Electronics,1028
08-09-2023 21:00,3323,2318,West,69,1226,204,Groceries,1005
08-09-2023 22:00,3427,1466,North,63,672,911,Electronics,1961
08-09-2023 23:00,4814,2977,North,76,1291,695,Clothing,1837
09-09-2023 00:00,2332,1669,South,75,967,639,Clothing,663
09-09-2023 01:00,2654,2047,North,81,1999,378,Furniture,607
09-09-2023 02:00,4339,2634,West,79,1222,111,Groceries,1705
09-09-2023 03:00,1944,608,West,76,1840,406,Furniture,1336
09-09-2023 04:00,4856,1868,North,75,896,463,Groceries,2988
09-09-2023 05:00,4135,2257,East,67,624,761,Electronics,1878
09-09-2023 06:00,3857,1493,North,94,1603,417,Electronics,2364
09-09-2023 07:00,4421,2017,North,72,1195,637,Groceries,2404
09-09-2023 08:00,1924,1856,South,93,1026,313,Groceries,68
09-09-2023 09:00,2938,1321,East,96,1919,413,Clothing,1617
09-09-2023 10:00,1493,1436,North,73,1612,554,Groceries,57
09-09-2023 11:00,2546,690,South,53,1526,498,Clothing,1856
09-09-2023 12:00,4169,2496,South,90,1035,851,Groceries,1673
09-09-2023 13:00,2969,1432,South,52,1100,321,Clothing,1537
09-09-2023 14:00,2094,641,West,92,1487,679,Furniture,1453
09-09-2023 15:00,3411,2392,South,79,1105,361,Clothing,1019
09-09-2023 16:00,3617,2715,South,96,1594,595,Furniture,902
09-09-2023 17:00,2825,1065,West,65,1199,722,Clothing,1760
09-09-2023 18:00,1762,1782,West,56,638,229,Electronics,-20
09-09-2023 19:00,3323,1962,South,88,509,258,Clothing,1361
09-09-2023 20:00,1049,1634,North,71,629,891,Groceries,-585
09-09-2023 21:00,4429,1243,East,90,900,390,Furniture,3186
09-09-2023 22:00,3775,1172,West,80,1744,914,Groceries,2603
09-09-2023 23:00,1905,1030,East,98,1141,642,Groceries,875
10-09-2023 00:00,3975,1813,West,62,936,188,Electronics,2162
10-09-2023 01:00,1563,1061,South,90,1923,431,Clothing,502
10-09-2023 02:00,1782,2033,West,90,1636,729,Electronics,-251
10-09-2023 03:00,3532,2722,South,78,1975,605,Clothing,810
10-09-2023 04:00,4155,801,East,77,1741,229,Groceries,3354
10-09-2023 05:00,4970,684,North,93,557,306,Clothing,4286
10-09-2023 06:00,4876,1009,South,68,1636,459,Electronics,3867
10-09-2023 07:00,4709,1833,East,72,1199,158,Furniture,2876
10-09-2023 08:00,3040,1869,East,96,1645,195,Electronics,1171
10-09-2023 09:00,2831,2703,West,99,907,930,Electronics,128
10-09-2023 10:00,1583,1294,South,57,1983,345,Electronics,289
10-09-2023 11:00,2319,2979,East,74,1608,558,Furniture,-660
10-09-2023 12:00,1235,2023,North,87,899,244,Groceries,-788
10-09-2023 13:00,3103,1260,West,87,855,409,Electronics,1843
10-09-2023 14:00,2942,2694,West,84,598,736,Electronics,248
10-09-2023 15:00,1359,934,East,75,1017,633,Electronics,425
10-09-2023 16:00,2930,2042,South,52,607,480,Furniture,888
10-09-2023 17:00,1109,2538,West,51,651,452,Furniture,-1429
10-09-2023 18:00,1191,2206,South,54,1405,983,Furniture,-1015
10-09-2023 19:00,1903,568,East,69,1349,384,Groceries,1335
10-09-2023 20:00,2116,2129,East,61,1248,818,Clothing,-13
10-09-2023 21:00,1861,2404,South,87,526,601,Groceries,-543
10-09-2023 22:00,3615,2733,North,65,618,357,Groceries,882
10-09-2023 23:00,2083,2751,West,86,1222,909,Groceries,-668
11-09-2023 00:00,1649,1053,East,87,599,151,Clothing,596
11-09-2023 01:00,1038,2560,North,85,502,649,Electronics,-1522
11-09-2023 02:00,4611,1797,North,95,1305,998,Furniture,2814
11-09-2023 03:00,4120,2598,South,78,1852,764,Groceries,1522
11-09-2023 04:00,4491,999,South,84,1629,944,Furniture,3492
11-09-2023 05:00,1636,2916,South,98,1753,315,Furniture,-1280
11-09-2023 06:00,2036,2904,North,86,803,545,Furniture,-868
11-09-2023 07:00,1035,2029,West,70,676,322,Electronics,-994
11-09-2023 08:00,3148,2803,South,70,583,754,Furniture,345
11-09-2023 09:00,4865,2011,West,77,762,204,Furniture,2854
11-09-2023 10:00,4157,778,South,55,1719,621,Electronics,3379
11-09-2023 11:00,4587,1582,North,69,1772,853,Furniture,3005
11-09-2023 12:00,4294,945,West,85,1905,987,Clothing,3349
11-09-2023 13:00,2361,2660,West,62,957,482,Clothing,-299
11-09-2023 14:00,2983,1335,North,89,908,213,Groceries,1648
11-09-2023 15:00,1165,1254,West,60,1604,844,Clothing,-89
11-09-2023 16:00,3430,2345,North,73,1935,168,Clothing,1085
11-09-2023 17:00,2879,2092,North,68,705,464,Clothing,787
11-09-2023 18:00,4966,2012,East,72,1319,143,Electronics,2954
11-09-2023 19:00,4447,1930,South,80,1514,780,Clothing,2517
11-09-2023 20:00,4542,2914,East,86,1301,310,Furniture,1628
11-09-2023 21:00,3837,1583,North,86,1394,375,Groceries,2254
11-09-2023 22:00,4713,2876,North,52,1372,206,Furniture,1837
11-09-2023 23:00,1030,2090,West,83,887,578,Furniture,-1060
12-09-2023 00:00,4446,2408,North,78,1393,778,Clothing,2038
12-09-2023 01:00,1010,2731,North,52,1266,304,Groceries,-1721
12-09-2023 02:00,3011,1522,North,64,1922,218,Furniture,1489
12-09-2023 03:00,4373,2858,South,56,1531,585,Groceries,1515
12-09-2023 04:00,3143,2061,East,52,949,208,Clothing,1082
12-09-2023 05:00,4261,676,East,96,1999,553,Furniture,3585
12-09-2023 06:00,3500,1346,South,92,841,338,Electronics,2154
12-09-2023 07:00,3239,1748,South,65,1596,107,Furniture,1491
12-09-2023 08:00,1485,2100,South,94,1359,611,Furniture,-615
12-09-2023 09:00,2289,2104,East,83,620,142,Groceries,185
12-09-2023 10:00,2447,2475,East,69,801,493,Groceries,-28
12-09-2023 11:00,4199,2556,North,93,1460,908,Groceries,1643
12-09-2023 12:00,3285,735,East,88,1383,231,Clothing,2550
12-09-2023 13:00,2943,1209,West,82,1380,817,Groceries,1734
12-09-2023 14:00,4426,1293,East,63,733,999,Clothing,3133
12-09-2023 15:00,2963,2434,South,91,565,891,Groceries,529
12-09-2023 16:00,4183,2169,East,84,729,850,Electronics,2014
12-09-2023 17:00,2851,526,North,60,1421,888,Groceries,2325
12-09-2023 18:00,2469,1726,East,69,550,493,Clothing,743
12-09-2023 19:00,2366,584,South,79,1158,657,Clothing,1782
12-09-2023 20:00,4216,2355,West,77,1852,297,Furniture,1861
12-09-2023 21:00,4136,1622,South,64,886,563,Groceries,2514
12-09-2023 22:00,4318,1713,West,87,1561,220,Clothing,2605
12-09-2023 23:00,3782,511,North,99,1252,399,Furniture,3271
13-09-2023 00:00,1990,1512,North,62,1696,319,Electronics,478
13-09-2023 01:00,4561,2248,East,96,992,967,Clothing,2313
13-09-2023 02:00,1824,2376,North,84,1978,900,Groceries,-552
13-09-2023 03:00,2462,1817,North,96,540,193,Electronics,645
13-09-2023 04:00,3153,1883,South,73,1445,391,Clothing,1270
13-09-2023 05:00,3228,2178,South,50,1652,252,Groceries,1050
13-09-2023 06:00,3231,679,East,91,1577,624,Clothing,2552
13-09-2023 07:00,1225,1296,East,73,585,818,Groceries,-71
13-09-2023 08:00,1776,1967,East,76,1792,866,Furniture,-191
13-09-2023 09:00,3837,2524,East,67,795,521,Clothing,1313
13-09-2023 10:00,4980,2988,South,75,1544,257,Clothing,1992
13-09-2023 11:00,2112,1386,East,78,1738,369,Electronics,726
13-09-2023 12:00,1687,2968,East,57,924,917,Furniture,-1281
13-09-2023 13:00,1529,1689,North,93,688,679,Electronics,-160
13-09-2023 14:00,4442,2175,East,75,660,356,Clothing,2267
13-09-2023 15:00,1971,2019,West,54,1212,800,Furniture,-48
13-09-2023 16:00,1935,2932,North,82,880,614,Groceries,-997
13-09-2023 17:00,4984,2861,South,89,743,336,Furniture,2123
13-09-2023 18:00,2422,1270,West,54,682,544,Furniture,1152
13-09-2023 19:00,3153,1778,East,98,1043,743,Groceries,1375
13-09-2023 20:00,2294,1458,North,96,1278,270,Clothing,836
13-09-2023 21:00,2998,1416,East,85,1447,369,Clothing,1582
13-09-2023 22:00,3878,2570,North,62,592,700,Electronics,1308
13-09-2023 23:00,2526,2281,East,66,867,714,Clothing,245
14-09-2023 00:00,1678,838,West,62,658,736,Clothing,840
14-09-2023 01:00,4596,2016,South,74,897,166,Groceries,2580
14-09-2023 02:00,3896,2913,West,51,1703,874,Electronics,983
14-09-2023 03:00,4103,1895,West,73,937,107,Furniture,2208
14-09-2023 04:00,3440,1414,South,85,872,655,Electronics,2026
14-09-2023 05:00,1039,2353,North,74,805,547,Clothing,-1314
14-09-2023 06:00,3707,974,North,83,1484,234,Electronics,2733
14-09-2023 07:00,4289,1946,South,61,1902,859,Furniture,2343
14-09-2023 08:00,4802,1879,East,68,1741,915,Groceries,2923
14-09-2023 09:00,4028,1983,North,99,1481,929,Clothing,2045
14-09-2023 10:00,2105,2574,West,91,828,124,Clothing,-469
14-09-2023 11:00,1844,1300,South,79,842,564,Furniture,544
14-09-2023 12:00,2743,1746,West,86,1223,473,Groceries,997
14-09-2023 13:00,3248,1363,North,92,1686,295,Electronics,1885
14-09-2023 14:00,1446,1671,South,50,657,803,Furniture,-225
14-09-2023 15:00,4915,1238,South,52,1633,980,Electronics,3677
14-09-2023 16:00,4499,1874,North,98,849,501,Groceries,2625
14-09-2023 17:00,4109,2962,North,75,1225,221,Groceries,1147
14-09-2023 18:00,2234,1481,South,64,864,871,Groceries,753
14-09-2023 19:00,3491,2976,East,95,514,658,Groceries,515
14-09-2023 20:00,2350,2588,South,96,652,985,Electronics,-238
14-09-2023 21:00,3808,1511,East,97,1031,308,Furniture,2297
14-09-2023 22:00,1226,2626,West,77,1466,400,Furniture,-1400
14-09-2023 23:00,1047,1216,East,53,1923,700,Electronics,-169
15-09-2023 00:00,4089,2307,East,68,1575,614,Groceries,1782
15-09-2023 01:00,3959,1973,North,73,1354,756,Groceries,1986
15-09-2023 02:00,2462,1665,South,89,968,985,Clothing,797
15-09-2023 03:00,2830,2841,West,55,1844,633,Clothing,-11
15-09-2023 04:00,4779,1109,South,65,1378,138,Electronics,3670
15-09-2023 05:00,1186,2683,East,81,1095,906,Furniture,-1497
15-09-2023 06:00,3392,2312,East,79,866,718,Clothing,1080
15-09-2023 07:00,3271,1835,East,84,1140,711,Clothing,1436
15-09-2023 08:00,3877,1054,South,57,1361,883,Furniture,2823
15-09-2023 09:00,3535,2155,East,54,1393,840,Clothing,1380
15-09-2023 10:00,2932,2255,South,86,1539,985,Furniture,677
15-09-2023 11:00,3924,545,West,61,1934,896,Electronics,3379
15-09-2023 12:00,1848,1759,West,74,1797,305,Clothing,89
15-09-2023 13:00,3032,1571,South,82,1088,682,Groceries,1461
15-09-2023 14:00,2252,2745,West,88,1829,780,Electronics,-493
15-09-2023 15:00,2413,2631,North,73,591,796,Clothing,-218
15-09-2023 16:00,1978,1042,East,60,957,511,Furniture,936
15-09-2023 17:00,2612,1951,East,91,1793,432,Electronics,661
15-09-2023 18:00,2016,2618,East,84,1575,307,Clothing,-602
15-09-2023 19:00,3235,2492,North,89,1644,504,Electronics,743
15-09-2023 20:00,2881,1412,East,50,1573,487,Groceries,1469
15-09-2023 21:00,1269,1568,South,57,1998,586,Clothing,-299
15-09-2023 22:00,2630,2840,East,72,1903,481,Clothing,-210
15-09-2023 23:00,1309,1311,South,69,886,966,Furniture,-2
16-09-2023 00:00,4203,1988,West,81,1812,983,Electronics,2215
16-09-2023 01:00,3043,2408,South,60,1977,370,Groceries,635
16-09-2023 02:00,2574,2073,South,56,870,536,Furniture,501
16-09-2023 03:00,2095,1366,South,79,683,957,Clothing,729
16-09-2023 04:00,4864,2927,East,97,1271,529,Furniture,1937
16-09-2023 05:00,3892,2266,North,88,704,746,Furniture,1626
16-09-2023 06:00,2695,2809,North,62,1453,757,Groceries,-114
16-09-2023 07:00,4258,1079,South,91,671,444,Clothing,3179
16-09-2023 08:00,3533,2904,East,98,1324,248,Groceries,629
16-09-2023 09:00,4262,1942,North,52,721,727,Clothing,2320
16-09-2023 10:00,2445,1197,West,56,1691,491,Electronics,1248
16-09-2023 11:00,3167,2476,West,92,1767,286,Electronics,691
16-09-2023 12:00,1219,2990,East,62,1741,119,Groceries,-1771
16-09-2023 13:00,1052,1225,West,86,1579,437,Furniture,-173
16-09-2023 14:00,2757,785,West,74,1114,472,Clothing,1972
16-09-2023 15:00,2474,2391,West,72,666,855,Clothing,83
16-09-2023 16:00,4483,1069,North,96,641,166,Groceries,3414
16-09-2023 17:00,2666,2464,West,82,624,538,Furniture,202
16-09-2023 18:00,2260,2013,South,54,589,161,Furniture,247
16-09-2023 19:00,3805,997,South,81,810,585,Clothing,2808
16-09-2023 20:00,3785,2417,West,79,1894,885,Electronics,1368
16-09-2023 21:00,1719,1204,South,80,1451,958,Clothing,515
16-09-2023 22:00,1405,1856,North,62,715,721,Electronics,-451
16-09-2023 23:00,3655,1061,East,91,1964,667,Groceries,2594
17-09-2023 00:00,4068,2498,South,54,1709,184,Furniture,1570
17-09-2023 01:00,3469,531,West,72,1382,505,Clothing,2938
17-09-2023 02:00,3759,542,East,50,1676,875,Groceries,3217
17-09-2023 03:00,3294,2416,East,59,1260,494,Furniture,878
17-09-2023 04:00,1071,1874,West,99,595,718,Electronics,-803
17-09-2023 05:00,2853,2345,South,76,1209,623,Groceries,508
17-09-2023 06:00,3232,1058,North,57,1859,275,Groceries,2174
17-09-2023 07:00,3053,2817,South,52,648,458,Clothing,236
17-09-2023 08:00,2229,1936,South,68,1427,930,Groceries,293
17-09-2023 09:00,2567,1442,North,51,1214,638,Groceries,1125
17-09-2023 10:00,4682,2098,East,98,1382,390,Clothing,2584
17-09-2023 11:00,3953,1870,North,80,1925,229,Groceries,2083
17-09-2023 12:00,1386,2428,North,97,1854,838,Electronics,-1042
17-09-2023 13:00,2791,2136,West,59,1750,578,Clothing,655
17-09-2023 14:00,1698,2584,West,65,857,747,Electronics,-886
17-09-2023 15:00,4147,591,South,86,1087,631,Clothing,3556
17-09-2023 16:00,2200,2343,West,69,815,363,Furniture,-143
17-09-2023 17:00,1826,684,North,52,1384,935,Groceries,1142
17-09-2023 18:00,2822,1227,North,84,1559,770,Furniture,1595
17-09-2023 19:00,1348,1551,West,83,1951,602,Electronics,-203
17-09-2023 20:00,2278,2071,West,70,949,259,Furniture,207
17-09-2023 21:00,4908,2919,West,85,1344,953,Electronics,1989
17-09-2023 22:00,4773,1331,North,81,589,637,Furniture,3442
17-09-2023 23:00,1307,844,East,67,1040,180,Electronics,463
18-09-2023 00:00,4416,1942,East,83,675,512,Groceries,2474
18-09-2023 01:00,2150,1719,West,87,1943,574,Furniture,431
18-09-2023 02:00,2960,2625,South,52,1147,987,Electronics,335
18-09-2023 03:00,3334,666,South,52,1400,117,Electronics,2668
18-09-2023 04:00,1765,763,East,76,1186,168,Furniture,1002
18-09-2023 05:00,1724,1995,West,51,1694,229,Furniture,-271
18-09-2023 06:00,3809,1731,North,52,893,746,Furniture,2078
18-09-2023 07:00,2619,1786,South,66,1789,914,Groceries,833
18-09-2023 08:00,4558,2029,South,95,1003,990,Groceries,2529
18-09-2023 09:00,1382,2308,North,88,1657,829,Groceries,-926
18-09-2023 10:00,4477,2377,North,87,1455,409,Furniture,2100
18-09-2023 11:00,3435,2249,West,89,1549,586,Electronics,1186
18-09-2023 12:00,1524,2409,North,68,1800,114,Electronics,-885
18-09-2023 13:00,4628,1835,North,68,599,595,Electronics,2793
18-09-2023 14:00,3686,1697,North,93,1965,285,Clothing,1989
18-09-2023 15:00,3985,2978,East,54,924,516,Furniture,1007
18-09-2023 16:00,4697,1267,North,54,1553,806,Electronics,3430
18-09-2023 17:00,1275,600,South,63,1405,802,Furniture,675
18-09-2023 18:00,3547,2232,West,76,995,845,Furniture,1315
18-09-2023 19:00,3764,2419,West,98,1150,531,Electronics,1345
18-09-2023 20:00,1336,2791,West,97,1497,165,Furniture,-1455
18-09-2023 21:00,2973,1871,East,85,1714,180,Clothing,1102
18-09-2023 22:00,3979,604,South,89,1710,135,Clothing,3375
18-09-2023 23:00,1480,1193,North,84,639,846,Electronics,287
19-09-2023 00:00,4968,2190,South,70,819,116,Furniture,2778
19-09-2023 01:00,1910,1810,West,54,868,613,Clothing,100
19-09-2023 02:00,2996,1570,North,73,796,132,Electronics,1426
19-09-2023 03:00,4344,1566,West,88,1723,448,Groceries,2778
19-09-2023 04:00,4991,1317,West,99,1295,479,Groceries,3674
19-09-2023 05:00,4129,2768,West,73,1902,607,Groceries,1361
19-09-2023 06:00,2351,2036,South,89,1603,745,Groceries,315
19-09-2023 07:00,3033,2691,South,92,1970,967,Clothing,342
19-09-2023 08:00,2754,1389,West,95,1000,955,Electronics,1365
19-09-2023 09:00,1108,2377,West,99,758,366,Clothing,-1269
19-09-2023 10:00,4350,2373,North,62,1644,616,Groceries,1977
19-09-2023 11:00,4757,1289,West,87,1578,897,Furniture,3468
19-09-2023 12:00,1327,1052,West,94,517,584,Groceries,275
19-09-2023 13:00,2799,1343,West,50,1832,446,Furniture,1456
19-09-2023 14:00,1314,1158,West,92,609,702,Electronics,156
19-09-2023 15:00,4545,1518,South,88,830,763,Clothing,3027
19-09-2023 16:00,2134,2453,West,59,1445,542,Furniture,-319
19-09-2023 17:00,3746,1690,East,51,1787,477,Groceries,2056
19-09-2023 18:00,1780,1250,West,65,767,729,Clothing,530
19-09-2023 19:00,4300,2796,South,86,934,672,Furniture,1504
19-09-2023 20:00,2520,1274,East,65,949,457,Electronics,1246
19-09-2023 21:00,1155,1880,East,72,796,637,Furniture,-725
19-09-2023 22:00,2496,1191,West,75,1660,720,Furniture,1305
19-09-2023 23:00,2724,1218,West,65,1218,979,Electronics,1506
20-09-2023 00:00,4343,733,South,76,1520,906,Clothing,3610
20-09-2023 01:00,1886,2571,East,96,1920,309,Electronics,-685
20-09-2023 02:00,4073,1904,East,90,683,870,Clothing,2169
20-09-2023 03:00,3805,1505,South,79,911,905,Clothing,2300
20-09-2023 04:00,1721,1869,West,82,819,141,Clothing,-148
20-09-2023 05:00,4582,1901,North,81,1240,915,Furniture,2681
20-09-2023 06:00,1912,2564,North,58,1849,112,Groceries,-652
20-09-2023 07:00,4357,2792,East,60,1304,700,Groceries,1565
20-09-2023 08:00,1870,1216,East,86,916,699,Furniture,654
20-09-2023 09:00,1012,2062,West,55,1381,923,Clothing,-1050
20-09-2023 10:00,3655,2211,North,79,1290,588,Electronics,1444
20-09-2023 11:00,1497,1725,East,89,589,286,Electronics,-228
20-09-2023 12:00,2756,1771,West,64,1258,162,Groceries,985
20-09-2023 13:00,3285,2665,North,97,1964,435,Clothing,620
20-09-2023 14:00,2117,508,South,79,1598,654,Furniture,1609
20-09-2023 15:00,4409,1097,East,67,1073,844,Furniture,3312
20-09-2023 16:00,3828,522,South,61,1790,845,Groceries,3306
20-09-2023 17:00,2194,2490,North,53,1462,174,Clothing,-296
20-09-2023 18:00,3004,2787,West,65,1435,864,Electronics,217
20-09-2023 19:00,3653,2108,West,72,1835,924,Electronics,1545
20-09-2023 20:00,3708,2574,North,60,1551,248,Furniture,1134
20-09-2023 21:00,2647,1604,South,73,1865,793,Groceries,1043
20-09-2023 22:00,2590,2746,West,71,925,306,Furniture,-156
20-09-2023 23:00,3896,591,East,88,1382,792,Electronics,3305
21-09-2023 00:00,3983,1350,South,64,1285,784,Furniture,2633
21-09-2023 01:00,2490,2482,South,98,1034,340,Clothing,8
21-09-2023 02:00,3675,1607,East,64,1933,775,Electronics,2068
21-09-2023 03:00,1142,799,North,59,784,674,Electronics,343
21-09-2023 04:00,2224,2843,West,77,1121,993,Furniture,-619
21-09-2023 05:00,4251,1977,South,85,1629,334,Furniture,2274
21-09-2023 06:00,3761,1804,West,66,1003,224,Groceries,1957
21-09-2023 07:00,4435,1500,West,85,545,356,Furniture,2935
21-09-2023 08:00,3526,1582,South,71,1970,191,Clothing,1944
21-09-2023 09:00,1564,1865,North,72,1667,836,Groceries,-301
21-09-2023 10:00,3518,2889,South,78,1036,806,Groceries,629
21-09-2023 11:00,3431,2609,North,71,561,986,Electronics,822
21-09-2023 12:00,2715,1275,East,60,1605,306,Clothing,1440
21-09-2023 13:00,3973,1952,North,85,835,516,Clothing,2021
21-09-2023 14:00,1416,2181,North,93,710,387,Groceries,-765
21-09-2023 15:00,2848,2251,South,78,899,314,Groceries,597
21-09-2023 16:00,3355,2803,West,91,1208,797,Electronics,552
21-09-2023 17:00,3696,2351,West,81,846,737,Furniture,1345
21-09-2023 18:00,2717,2397,North,63,1721,893,Clothing,320
21-09-2023 19:00,2390,2229,North,67,876,866,Clothing,161
21-09-2023 20:00,4072,1827,South,87,1685,611,Electronics,2245
21-09-2023 21:00,2067,1114,North,86,1731,672,Groceries,953
21-09-2023 22:00,3786,744,South,83,1320,467,Clothing,3042
21-09-2023 23:00,2866,1256,East,94,1418,500,Electronics,1610
22-09-2023 00:00,2121,1323,North,72,1950,300,Groceries,798
22-09-2023 01:00,4791,2346,East,81,543,680,Electronics,2445
22-09-2023 02:00,2288,1935,North,95,1299,384,Clothing,353
22-09-2023 03:00,4871,1740,North,52,1802,162,Groceries,3131
22-09-2023 04:00,2806,1015,East,92,1286,745,Electronics,1791
22-09-2023 05:00,3187,973,East,71,1232,850,Electronics,2214
22-09-2023 06:00,2504,535,South,72,1467,863,Electronics,1969
22-09-2023 07:00,4308,1910,South,53,1669,460,Clothing,2398
22-09-2023 08:00,4021,2292,East,62,1592,286,Clothing,1729
22-09-2023 09:00,2016,2234,North,81,1151,582,Furniture,-218
22-09-2023 10:00,1952,1329,South,78,1021,470,Clothing,623
22-09-2023 11:00,3951,1592,North,89,610,120,Electronics,2359
22-09-2023 12:00,1071,2913,West,89,1107,954,Clothing,-1842
22-09-2023 13:00,2690,1685,South,94,1578,902,Electronics,1005
22-09-2023 14:00,4261,2262,South,59,1746,407,Electronics,1999
22-09-2023 15:00,2291,1444,South,62,1395,145,Electronics,847
22-09-2023 16:00,2344,2011,West,94,1023,293,Groceries,333
22-09-2023 17:00,3154,930,East,66,645,156,Furniture,2224
22-09-2023 18:00,4303,2522,North,87,763,653,Furniture,1781
22-09-2023 19:00,4113,1358,West,51,967,556,Electronics,2755
22-09-2023 20:00,4773,729,East,66,1371,432,Clothing,4044
22-09-2023 21:00,1882,2917,South,93,1458,846,Furniture,-1035
22-09-2023 22:00,1138,677,East,75,1710,965,Electronics,461
22-09-2023 23:00,3662,1933,East,87,1866,115,Clothing,1729
23-09-2023 00:00,4754,2113,East,86,1622,744,Groceries,2641
23-09-2023 01:00,3910,2263,North,54,1178,612,Groceries,1647
23-09-2023 02:00,3320,2274,East,74,1829,843,Electronics,1046
23-09-2023 03:00,2504,1474,East,58,1722,249,Clothing,1030
23-09-2023 04:00,3463,581,East,77,1257,915,Groceries,2882
23-09-2023 05:00,3553,1345,East,71,1677,733,Groceries,2208
23-09-2023 06:00,1732,1716,West,78,1418,893,Groceries,16
23-09-2023 07:00,2748,1117,West,84,1619,901,Clothing,1631
23-09-2023 08:00,4924,2763,East,69,1074,981,Electronics,2161
23-09-2023 09:00,1423,2837,East,54,1205,925,Electronics,-1414
23-09-2023 10:00,4478,944,East,88,1333,312,Groceries,3534
23-09-2023 11:00,2591,1422,South,93,1882,490,Electronics,1169
23-09-2023 12:00,1389,692,East,81,1313,380,Furniture,697
23-09-2023 13:00,1341,2162,East,88,898,751,Groceries,-821
23-09-2023 14:00,1945,788,West,59,1899,770,Clothing,1157
23-09-2023 15:00,1613,1667,West,89,1101,638,Electronics,-54
23-09-2023 16:00,1492,1930,West,66,827,441,Clothing,-438
23-09-2023 17:00,1191,2334,North,86,1795,773,Electronics,-1143
23-09-2023 18:00,1498,2470,South,64,1818,729,Clothing,-972
23-09-2023 19:00,1821,1395,East,58,894,436,Clothing,426
23-09-2023 20:00,2735,1419,West,81,1995,174,Electronics,1316
23-09-2023 21:00,2256,2534,North,72,1047,192,Groceries,-278
23-09-2023 22:00,2968,2052,East,60,1541,645,Groceries,916
23-09-2023 23:00,1226,2200,East,62,1418,214,Clothing,-974
24-09-2023 00:00,2394,2560,West,67,576,520,Furniture,-166
24-09-2023 01:00,3186,2225,East,98,1572,212,Clothing,961
24-09-2023 02:00,3903,2887,East,58,1949,467,Furniture,1016
24-09-2023 03:00,1816,2397,East,91,1517,159,Groceries,-581
24-09-2023 04:00,4220,2299,West,54,628,381,Furniture,1921
24-09-2023 05:00,4186,811,North,92,1018,336,Electronics,3375
24-09-2023 06:00,2473,1627,East,71,803,737,Furniture,846
24-09-2023 07:00,2086,838,North,81,1635,144,Electronics,1248
24-09-2023 08:00,1103,2847,East,96,1224,899,Clothing,-1744
24-09-2023 09:00,2874,858,West,51,1411,840,Furniture,2016
24-09-2023 10:00,1870,2716,North,70,1315,296,Electronics,-846
24-09-2023 11:00,1667,1672,West,77,1473,823,Clothing,-5
24-09-2023 12:00,3042,1267,South,73,1318,598,Furniture,1775
24-09-2023 13:00,1272,2589,East,73,862,682,Furniture,-1317
24-09-2023 14:00,2029,701,South,63,1589,846,Electronics,1328
24-09-2023 15:00,4218,2192,South,86,1554,890,Clothing,2026
24-09-2023 16:00,3231,963,South,76,1818,548,Electronics,2268
24-09-2023 17:00,2051,948,East,73,1308,778,Furniture,1103
24-09-2023 18:00,2573,1412,West,55,1842,294,Clothing,1161
24-09-2023 19:00,4190,1297,South,75,1537,784,Groceries,2893
24-09-2023 20:00,1292,1293,North,64,1069,294,Groceries,-1
24-09-2023 21:00,4442,936,East,78,1469,674,Groceries,3506
24-09-2023 22:00,4315,2416,West,85,1765,681,Furniture,1899
24-09-2023 23:00,4651,2273,West,59,852,834,Groceries,2378
25-09-2023 00:00,4797,1030,South,77,1771,409,Furniture,3767
25-09-2023 01:00,4289,1064,East,58,1109,894,Clothing,3225
25-09-2023 02:00,3224,2120,South,70,967,960,Electronics,1104
25-09-2023 03:00,4370,1796,North,59,1423,690,Furniture,2574
25-09-2023 04:00,4747,712,West,53,887,647,Clothing,4035
25-09-2023 05:00,3105,1448,West,53,1258,488,Clothing,1657
25-09-2023 06:00,2292,1627,East,55,941,806,Clothing,665
25-09-2023 07:00,1307,691,West,75,1865,534,Electronics,616
25-09-2023 08:00,4641,1903,East,89,1015,828,Furniture,2738
25-09-2023 09:00,4359,2490,South,65,1342,899,Clothing,1869
25-09-2023 10:00,1976,1604,North,57,544,760,Groceries,372
25-09-2023 11:00,4176,1204,East,77,1942,595,Groceries,2972
25-09-2023 12:00,2251,1048,South,65,1222,884,Clothing,1203
25-09-2023 13:00,2270,2361,North,87,1255,300,Groceries,-91
25-09-2023 14:00,3747,653,West,98,702,765,Groceries,3094
25-09-2023 15:00,2517,2165,North,50,1038,633,Furniture,352
25-09-2023 16:00,3130,1070,North,68,885,396,Electronics,2060
25-09-2023 17:00,2209,2284,North,99,1129,593,Furniture,-75
25-09-2023 18:00,3299,2787,West,66,1467,926,Clothing,512
25-09-2023 19:00,2378,2921,East,98,1237,826,Clothing,-543
25-09-2023 20:00,2773,1304,East,77,859,430,Groceries,1469
25-09-2023 21:00,4943,1298,North,93,1991,733,Furniture,3645
25-09-2023 22:00,2719,1110,South,61,1482,877,Clothing,1609
25-09-2023 23:00,3042,2306,South,55,704,954,Clothing,736
26-09-2023 00:00,1795,642,North,56,1770,360,Groceries,1153
26-09-2023 01:00,1896,771,North,57,1490,154,Groceries,1125
26-09-2023 02:00,2961,2055,South,52,1572,381,Clothing,906
26-09-2023 03:00,1209,2973,North,98,865,871,Furniture,-1764
26-09-2023 04:00,3863,2593,North,70,752,974,Electronics,1270
26-09-2023 05:00,4879,2642,East,57,577,894,Furniture,2237
26-09-2023 06:00,3656,2611,East,77,1268,841,Groceries,1045
26-09-2023 07:00,3494,2960,North,79,1131,737,Clothing,534
26-09-2023 08:00,3507,958,North,81,1486,541,Groceries,2549
26-09-2023 09:00,1967,2238,West,60,916,358,Clothing,-271
26-09-2023 10:00,1471,1932,East,69,1558,661,Clothing,-461
26-09-2023 11:00,4791,1005,North,99,1961,835,Electronics,3786
26-09-2023 12:00,3417,2209,West,65,811,992,Groceries,1208
26-09-2023 13:00,3947,1596,West,74,1666,893,Electronics,2351
26-09-2023 14:00,4563,583,West,94,696,245,Furniture,3980
26-09-2023 15:00,1922,558,West,58,1496,490,Groceries,1364
26-09-2023 16:00,1136,1544,East,88,759,472,Electronics,-408
26-09-2023 17:00,1366,1981,West,98,1889,144,Groceries,-615
26-09-2023 18:00,3959,2704,East,89,1095,496,Electronics,1255
26-09-2023 19:00,1183,1852,West,89,1715,361,Electronics,-669
26-09-2023 20:00,4659,2096,West,52,1033,578,Groceries,2563
26-09-2023 21:00,4358,1075,South,65,523,845,Furniture,3283
26-09-2023 22:00,3519,1179,East,61,1442,664,Electronics,2340
26-09-2023 23:00,2398,702,South,64,1598,584,Electronics,1696
27-09-2023 00:00,3701,1629,South,53,1422,846,Groceries,2072
27-09-2023 01:00,3796,817,West,72,1917,807,Furniture,2979
27-09-2023 02:00,1536,1705,East,76,1178,615,Groceries,-169
27-09-2023 03:00,4582,2138,North,88,1981,671,Clothing,2444
27-09-2023 04:00,3849,2296,West,92,609,784,Groceries,1553
27-09-2023 05:00,2602,905,East,86,589,683,Clothing,1697
27-09-2023 06:00,2273,1178,South,62,536,585,Electronics,1095
27-09-2023 07:00,3967,1770,East,92,1321,686,Furniture,2197
27-09-2023 08:00,3557,2389,West,86,1492,933,Furniture,1168
27-09-2023 09:00,3677,2047,East,89,1071,565,Groceries,1630
27-09-2023 10:00,4049,2143,South,70,1083,565,Clothing,1906
27-09-2023 11:00,2096,1859,East,78,806,121,Groceries,237
27-09-2023 12:00,2305,1945,East,78,561,495,Furniture,360
27-09-2023 13:00,1915,1334,South,98,804,308,Clothing,581
27-09-2023 14:00,4431,2741,West,60,678,662,Furniture,1690
27-09-2023 15:00,4081,2855,North,99,1039,244,Clothing,1226
27-09-2023 16:00,4282,2168,South,77,1431,519,Groceries,2114
27-09-2023 17:00,4906,2430,South,59,1431,448,Electronics,2476
27-09-2023 18:00,1151,780,West,54,1344,404,Electronics,371
27-09-2023 19:00,2028,2313,West,74,1967,883,Clothing,-285
27-09-2023 20:00,2218,1432,East,82,1559,143,Clothing,786
27-09-2023 21:00,2977,1107,South,66,1249,206,Electronics,1870
27-09-2023 22:00,4354,982,East,98,1596,249,Groceries,3372
27-09-2023 23:00,3511,1746,East,82,1553,705,Groceries,1765
28-09-2023 00:00,4184,2272,West,74,1238,363,Furniture,1912
28-09-2023 01:00,1270,2664,West,82,1826,209,Furniture,-1394
28-09-2023 02:00,2186,691,East,58,1870,117,Electronics,1495
28-09-2023 03:00,1459,2517,South,76,1296,849,Electronics,-1058
28-09-2023 04:00,1104,806,South,74,1588,435,Electronics,298
28-09-2023 05:00,4764,1031,East,53,1246,338,Clothing,3733
28-09-2023 06:00,4627,621,North,58,1126,985,Furniture,4006
28-09-2023 07:00,4353,1091,North,95,952,823,Electronics,3262
28-09-2023 08:00,2710,1975,West,64,1330,842,Electronics,735
28-09-2023 09:00,3209,558,South,65,1257,427,Furniture,2651
28-09-2023 10:00,3398,2848,East,65,1360,961,Electronics,550
28-09-2023 11:00,1433,2073,East,62,1318,393,Electronics,-640
28-09-2023 12:00,3899,1640,South,63,1892,512,Groceries,2259
28-09-2023 13:00,1139,2310,West,71,1560,560,Furniture,-1171
28-09-2023 14:00,2494,2305,West,70,880,180,Groceries,189
28-09-2023 15:00,4203,898,North,58,1742,354,Furniture,3305
28-09-2023 16:00,1086,1441,South,90,1148,843,Electronics,-355
28-09-2023 17:00,2711,1027,South,53,745,462,Clothing,1684
28-09-2023 18:00,3230,2945,East,59,750,820,Clothing,285
28-09-2023 19:00,3415,2274,South,84,1064,556,Groceries,1141
28-09-2023 20:00,1128,1921,North,58,1408,997,Clothing,-793
28-09-2023 21:00,2269,2169,South,97,1869,542,Clothing,100
28-09-2023 22:00,4672,2050,East,65,1320,909,Groceries,2622
28-09-2023 23:00,2601,935,North,98,1214,985,Electronics,1666
29-09-2023 00:00,1669,1339,East,67,971,632,Furniture,330
29-09-2023 01:00,4970,859,South,59,621,337,Electronics,4111
29-09-2023 02:00,4449,1652,West,70,1849,997,Groceries,2797
29-09-2023 03:00,1148,1363,South,64,1280,360,Electronics,-215
29-09-2023 04:00,1984,2150,South,64,1247,372,Electronics,-166
29-09-2023 05:00,1851,2232,East,60,620,379,Groceries,-381
29-09-2023 06:00,2456,1745,West,89,638,249,Groceries,711
29-09-2023 07:00,1627,2761,South,97,586,926,Groceries,-1134
29-09-2023 08:00,4797,1415,North,91,629,251,Clothing,3382
29-09-2023 09:00,2492,2298,North,90,751,893,Groceries,194
29-09-2023 10:00,3493,2682,East,96,1286,672,Groceries,811
29-09-2023 11:00,3044,885,East,86,1883,747,Groceries,2159
29-09-2023 12:00,4552,1826,West,69,1953,111,Groceries,2726
29-09-2023 13:00,1883,2305,East,83,546,113,Electronics,-422
29-09-2023 14:00,3341,2085,West,71,1000,610,Groceries,1256
29-09-2023 15:00,2788,1712,South,97,924,641,Furniture,1076
29-09-2023 16:00,4214,2049,North,67,1898,966,Groceries,2165
29-09-2023 17:00,1249,888,North,65,1464,544,Furniture,361
29-09-2023 18:00,3925,1203,North,54,1230,417,Furniture,2722
29-09-2023 19:00,1947,2238,East,50,610,898,Clothing,-291
29-09-2023 20:00,1974,1363,East,68,1750,831,Clothing,611
29-09-2023 21:00,2325,1559,South,59,1562,337,Electronics,766
29-09-2023 22:00,4096,578,East,70,634,638,Groceries,3518
29-09-2023 23:00,3836,1798,West,62,1818,868,Groceries,2038
30-09-2023 00:00,1983,1801,North,73,1109,908,Furniture,182
30-09-2023 01:00,1888,1173,South,72,1557,753,Groceries,715
30-09-2023 02:00,3937,2859,West,72,1486,861,Furniture,1078
30-09-2023 03:00,4972,703,West,60,927,173,Clothing,4269
30-09-2023 04:00,3117,1484,East,96,1591,533,Electronics,1633
30-09-2023 05:00,3672,2475,East,51,698,397,Clothing,1197
30-09-2023 06:00,1874,516,North,55,1059,810,Groceries,1358
30-09-2023 07:00,4183,975,South,60,758,395,Furniture,3208
30-09-2023 08:00,4435,1516,West,64,1224,113,Clothing,2919
30-09-2023 09:00,2326,709,East,58,1173,711,Groceries,1617
30-09-2023 10:00,1470,998,East,61,636,702,Furniture,472
30-09-2023 11:00,2987,928,South,85,1415,494,Groceries,2059
30-09-2023 12:00,1090,1829,South,77,1435,290,Groceries,-739
30-09-2023 13:00,1529,2605,East,72,880,973,Electronics,-1076
30-09-2023 14:00,1660,2053,East,76,737,916,Clothing,-393
30-09-2023 15:00,1738,1731,North,73,1807,520,Groceries,7
30-09-2023 16:00,3773,2034,South,63,1187,205,Groceries,1739
30-09-2023 17:00,1871,2367,West,84,957,493,Electronics,-496
30-09-2023 18:00,2686,2376,East,76,1658,537,Electronics,310
30-09-2023 19:00,1191,1398,East,70,581,106,Furniture,-207
30-09-2023 20:00,2986,1606,East,98,1094,180,Groceries,1380
30-09-2023 21:00,4623,1567,East,62,1153,864,Groceries,3056
30-09-2023 22:00,4313,2006,North,57,1732,751,Groceries,2307
30-09-2023 23:00,3185,2167,South,93,902,584,Groceries,1018
01-10-2023 00:00,1344,992,East,93,1321,456,Electronics,352
01-10-2023 01:00,4251,1104,South,93,687,410,Clothing,3147
01-10-2023 02:00,2008,1447,West,83,992,605,Electronics,561
01-10-2023 03:00,4783,793,West,91,754,618,Furniture,3990
01-10-2023 04:00,3550,1671,West,72,1846,763,Electronics,1879
01-10-2023 05:00,1202,2518,West,58,924,901,Clothing,-1316
01-10-2023 06:00,1572,671,South,50,1938,737,Groceries,901
01-10-2023 07:00,1191,2086,West,85,1690,548,Furniture,-895
01-10-2023 08:00,3052,1030,West,95,984,384,Furniture,2022
01-10-2023 09:00,2913,1643,East,65,935,381,Groceries,1270
01-10-2023 10:00,4308,2359,East,74,679,173,Clothing,1949
01-10-2023 11:00,2716,2260,East,67,1594,144,Electronics,456
01-10-2023 12:00,1310,2613,North,83,1400,628,Groceries,-1303
01-10-2023 13:00,3596,2688,East,87,1964,844,Clothing,908
01-10-2023 14:00,3103,2993,West,52,1143,775,Clothing,110
01-10-2023 15:00,1442,688,South,69,638,556,Clothing,754
01-10-2023 16:00,2260,657,West,68,1286,674,Groceries,1603
01-10-2023 17:00,1869,2470,South,62,601,506,Clothing,-601
01-10-2023 18:00,4932,745,West,66,967,192,Furniture,4187
01-10-2023 19:00,4268,2877,North,63,782,421,Furniture,1391
01-10-2023 20:00,1584,1349,East,79,1552,565,Electronics,235
01-10-2023 21:00,2594,2310,West,71,517,703,Electronics,284
01-10-2023 22:00,3799,1594,East,92,1255,984,Clothing,2205
01-10-2023 23:00,2537,1836,North,97,1186,653,Clothing,701
02-10-2023 00:00,4520,2626,North,92,1100,852,Clothing,1894
02-10-2023 01:00,1359,668,East,78,1543,426,Electronics,691
02-10-2023 02:00,2723,2727,East,99,1849,866,Furniture,-4
02-10-2023 03:00,3866,2151,South,51,1879,942,Furniture,1715
02-10-2023 04:00,3077,2807,East,57,932,682,Groceries,270
02-10-2023 05:00,2802,2009,East,63,1922,910,Electronics,793
02-10-2023 06:00,3011,2295,South,83,1541,827,Clothing,716
02-10-2023 07:00,3155,2844,West,62,875,922,Furniture,311
02-10-2023 08:00,1843,1119,South,59,1863,667,Groceries,724
02-10-2023 09:00,2625,2907,West,57,1673,690,Furniture,-282
02-10-2023 10:00,3764,2664,West,56,1510,514,Groceries,1100
02-10-2023 11:00,1890,856,West,62,1215,598,Clothing,1034
02-10-2023 12:00,2991,2986,South,75,1756,950,Clothing,5
02-10-2023 13:00,2982,2177,South,81,1627,539,Furniture,805
02-10-2023 14:00,1959,1711,North,68,1523,732,Electronics,248
02-10-2023 15:00,2468,1804,West,64,1236,813,Furniture,664
02-10-2023 16:00,3940,2034,South,51,720,531,Electronics,1906
02-10-2023 17:00,2461,1989,North,86,1549,427,Furniture,472
02-10-2023 18:00,1731,2463,West,68,1587,356,Electronics,-732
02-10-2023 19:00,4961,1861,South,82,753,741,Clothing,3100
02-10-2023 20:00,1605,698,South,88,1772,960,Groceries,907
02-10-2023 21:00,3504,2287,South,99,1235,653,Electronics,1217
02-10-2023 22:00,1614,1573,East,82,1325,173,Clothing,41
02-10-2023 23:00,4806,1665,North,50,1654,333,Groceries,3141
03-10-2023 00:00,3745,2306,South,88,529,620,Clothing,1439
03-10-2023 01:00,3004,2037,East,77,1286,981,Clothing,967
03-10-2023 02:00,2719,530,North,66,509,642,Clothing,2189
03-10-2023 03:00,4566,2880,North,55,1612,707,Electronics,1686
03-10-2023 04:00,1673,1159,East,93,929,357,Clothing,514
03-10-2023 05:00,2270,2724,North,69,1670,891,Clothing,-454
03-10-2023 06:00,3590,2917,East,96,1650,328,Clothing,673
03-10-2023 07:00,2587,1046,West,62,1197,344,Electronics,1541
03-10-2023 08:00,3904,1629,South,61,623,526,Furniture,2275
03-10-2023 09:00,2611,2644,East,79,1864,809,Clothing,-33
03-10-2023 10:00,1896,2777,North,70,550,555,Furniture,-881
03-10-2023 11:00,2462,2774,North,51,897,843,Clothing,-312
03-10-2023 12:00,1277,870,West,67,813,572,Electronics,407
03-10-2023 13:00,1551,1623,West,77,1147,910,Furniture,-72
03-10-2023 14:00,2636,1968,West,53,1013,662,Clothing,668
03-10-2023 15:00,3158,1991,West,91,1001,828,Furniture,1167
03-10-2023 16:00,3432,2602,West,92,1029,273,Groceries,830
03-10-2023 17:00,4904,2971,South,55,1196,174,Furniture,1933
03-10-2023 18:00,1760,2862,East,87,1233,198,Clothing,-1102
03-10-2023 19:00,4262,1651,West,58,1359,612,Furniture,2611
03-10-2023 20:00,4561,2579,West,69,918,223,Clothing,1982
03-10-2023 21:00,3741,592,South,94,693,216,Furniture,3149
03-10-2023 22:00,2449,1781,East,79,811,442,Furniture,668
03-10-2023 23:00,1404,2425,West,86,1495,806,Electronics,-1021
04-10-2023 00:00,2358,1743,East,87,1221,332,Electronics,615
04-10-2023 01:00,2232,2071,East,53,1822,228,Furniture,161
04-10-2023 02:00,1021,915,South,87,1852,473,Electronics,106
04-10-2023 03:00,1677,2913,South,99,975,674,Electronics,-1236
04-10-2023 04:00,3658,2044,West,62,1083,335,Groceries,1614
04-10-2023 05:00,3028,2878,North,84,616,943,Clothing,150
04-10-2023 06:00,2231,1188,South,79,763,841,Clothing,1043
04-10-2023 07:00,3055,2165,East,91,520,289,Groceries,890
04-10-2023 08:00,3749,2558,East,53,976,800,Furniture,1191
04-10-2023 09:00,4758,2030,West,74,1048,267,Electronics,2728
04-10-2023 10:00,2808,918,West,80,1696,706,Clothing,1890
04-10-2023 11:00,1528,1645,West,96,1447,768,Groceries,-117
04-10-2023 12:00,3037,1410,East,61,1520,390,Clothing,1627
04-10-2023 13:00,3649,1854,South,64,1585,959,Furniture,1795
04-10-2023 14:00,2676,2066,North,75,705,440,Groceries,610
04-10-2023 15:00,1656,2895,South,59,1130,494,Furniture,-1239
04-10-2023 16:00,1165,911,North,61,678,573,Furniture,254
04-10-2023 17:00,1848,1747,South,71,1387,238,Groceries,101
04-10-2023 18:00,1495,652,West,89,841,290,Clothing,843
04-10-2023 19:00,1589,1735,East,70,939,667,Electronics,-146
04-10-2023 20:00,1428,591,North,84,1598,618,Electronics,837
04-10-2023 21:00,3821,830,South,56,789,150,Groceries,2991
04-10-2023 22:00,1162,2164,East,67,1056,650,Electronics,-1002
04-10-2023 23:00,3413,1454,North,76,1667,397,Furniture,1959
05-10-2023 00:00,4597,1751,North,84,1148,171,Clothing,2846
05-10-2023 01:00,2262,693,East,96,707,355,Groceries,1569
05-10-2023 02:00,1071,1029,West,51,771,408,Furniture,42
05-10-2023 03:00,4516,1766,East,81,914,190,Furniture,2750
05-10-2023 04:00,1654,1973,West,64,1920,248,Clothing,-319
05-10-2023 05:00,4893,1138,South,94,883,129,Clothing,3755
05-10-2023 06:00,4580,2110,South,73,1784,561,Electronics,2470
05-10-2023 07:00,4866,2097,East,69,1390,734,Clothing,2769
05-10-2023 08:00,1268,2835,West,59,1690,484,Groceries,-1567
05-10-2023 09:00,2776,1197,South,73,1541,848,Groceries,1579
05-10-2023 10:00,3462,2545,West,73,1159,891,Clothing,917
05-10-2023 11:00,2268,2201,West,73,746,736,Clothing,67
05-10-2023 12:00,2015,1039,West,89,1819,745,Furniture,976
05-10-2023 13:00,3722,829,East,97,913,617,Groceries,2893
05-10-2023 14:00,2083,969,West,97,1843,994,Electronics,1114
05-10-2023 15:00,1005,1033,East,83,1214,472,Furniture,-28
05-10-2023 16:00,4780,2462,South,90,680,296,Furniture,2318
05-10-2023 17:00,1981,966,South,89,1819,289,Electronics,1015
05-10-2023 18:00,3617,2967,North,60,1443,902,Electronics,650
05-10-2023 19:00,4888,1261,North,75,1392,995,Clothing,3627
05-10-2023 20:00,1406,1505,South,50,560,847,Clothing,-99
05-10-2023 21:00,4288,1390,West,79,1732,178,Furniture,2898
05-10-2023 22:00,2953,2855,West,92,665,646,Groceries,98
05-10-2023 23:00,3073,2455,South,67,1508,915,Groceries,618
06-10-2023 00:00,4886,2881,South,75,1823,981,Furniture,2005
06-10-2023 01:00,4076,1453,North,96,1154,972,Groceries,2623
06-10-2023 02:00,1985,1943,West,58,850,171,Groceries,42
06-10-2023 03:00,4603,2172,South,58,1584,142,Electronics,2431
06-10-2023 04:00,1389,1331,North,50,762,902,Clothing,58
06-10-2023 05:00,1709,1343,North,56,623,232,Clothing,366
06-10-2023 06:00,3618,2797,West,93,1761,898,Furniture,821
06-10-2023 07:00,2471,1819,North,91,1431,205,Electronics,652
06-10-2023 08:00,1753,683,North,65,1613,770,Groceries,1070
06-10-2023 09:00,3193,1783,East,87,638,456,Furniture,1410
06-10-2023 10:00,2411,2190,South,60,1885,107,Furniture,221
06-10-2023 11:00,3832,2733,West,74,1936,873,Groceries,1099
06-10-2023 12:00,2272,1932,South,78,1359,442,Clothing,340
06-10-2023 13:00,1525,2296,East,68,1616,536,Groceries,-771
06-10-2023 14:00,2485,1126,West,67,633,179,Furniture,1359
06-10-2023 15:00,3060,2555,South,96,1727,655,Clothing,505
06-10-2023 16:00,3950,1282,North,78,1318,788,Furniture,2668
06-10-2023 17:00,3431,2007,West,65,1561,491,Electronics,1424
06-10-2023 18:00,1555,2284,East,95,1517,675,Clothing,-729
06-10-2023 19:00,3934,1274,North,89,956,999,Furniture,2660
06-10-2023 20:00,4470,2259,East,57,937,387,Furniture,2211
06-10-2023 21:00,1018,2363,North,83,1179,920,Electronics,-1345
06-10-2023 22:00,1574,1506,South,55,1146,212,Groceries,68
06-10-2023 23:00,4562,1176,South,94,1121,930,Clothing,3386
07-10-2023 00:00,3798,2330,South,94,1747,981,Furniture,1468
07-10-2023 01:00,2003,710,East,79,1691,819,Furniture,1293
07-10-2023 02:00,3466,1836,West,93,1630,325,Furniture,1630
07-10-2023 03:00,4408,2127,South,83,1903,432,Furniture,2281
07-10-2023 04:00,3466,1860,East,70,523,516,Groceries,1606
07-10-2023 05:00,2938,989,North,61,1308,377,Groceries,1949
07-10-2023 06:00,2939,1926,South,98,1830,994,Groceries,1013
07-10-2023 07:00,2635,690,North,55,1434,898,Clothing,1945
07-10-2023 08:00,2698,1342,South,88,1881,891,Groceries,1356
07-10-2023 09:00,4999,834,North,55,869,102,Clothing,4165
07-10-2023 10:00,3169,2142,East,53,1496,644,Groceries,1027
07-10-2023 11:00,1431,1610,South,58,670,577,Furniture,-179
07-10-2023 12:00,3091,1078,East,54,721,509,Electronics,2013
07-10-2023 13:00,2895,561,East,59,942,406,Clothing,2334
07-10-2023 14:00,2943,886,North,96,1676,313,Electronics,2057
07-10-2023 15:00,2340,1669,South,57,1361,129,Electronics,671
07-10-2023 16:00,3428,2700,West,72,875,518,Furniture,728
07-10-2023 17:00,1144,1118,West,53,780,636,Furniture,26
07-10-2023 18:00,4398,2183,East,86,1212,127,Clothing,2215
07-10-2023 19:00,3410,2377,North,56,1742,708,Clothing,1033
07-10-2023 20:00,2073,2725,North,55,1457,186,Clothing,-652
07-10-2023 21:00,2088,986,North,94,1310,125,Groceries,1102
07-10-2023 22:00,3402,1777,South,91,1326,219,Groceries,1625
07-10-2023 23:00,1799,1040,South,64,985,812,Electronics,759
08-10-2023 00:00,4235,2035,North,84,834,491,Clothing,2200
08-10-2023 01:00,4212,2560,West,99,1241,456,Electronics,1652
08-10-2023 02:00,3873,650,West,81,909,452,Groceries,3223
08-10-2023 03:00,2151,1573,South,63,553,114,Electronics,578
08-10-2023 04:00,3445,1738,North,84,1200,404,Electronics,1707
08-10-2023 05:00,2956,1490,West,60,1598,353,Clothing,1466
08-10-2023 06:00,3927,871,West,59,848,722,Clothing,3056
08-10-2023 07:00,1462,1636,South,66,1474,619,Electronics,-174
08-10-2023 08:00,2774,2799,South,62,892,952,Groceries,-25
08-10-2023 09:00,3045,2600,West,83,1053,739,Electronics,445
08-10-2023 10:00,4907,1653,North,94,1680,285,Groceries,3254
08-10-2023 11:00,1807,692,West,54,1346,486,Electronics,1115
08-10-2023 12:00,1186,1580,West,97,580,599,Electronics,-394
08-10-2023 13:00,2743,2644,North,59,1731,113,Clothing,99
08-10-2023 14:00,1731,697,South,81,1325,329,Electronics,1034
08-10-2023 15:00,2935,2694,North,61,1609,190,Groceries,241
08-10-2023 16:00,2213,2098,North,62,1243,503,Electronics,115
08-10-2023 17:00,2411,2100,North,70,1970,604,Electronics,311
08-10-2023 18:00,1428,1183,North,97,676,103,Groceries,245
08-10-2023 19:00,3905,832,South,82,1010,763,Electronics,3073
08-10-2023 20:00,2307,1743,West,90,638,318,Electronics,564
08-10-2023 21:00,4935,1921,East,97,1625,687,Electronics,3014
08-10-2023 22:00,3284,1865,South,96,972,895,Electronics,1419
08-10-2023 23:00,2217,2321,North,99,1041,966,Groceries,-104
09-10-2023 00:00,2310,2719,West,81,693,315,Furniture,-409
09-10-2023 01:00,1770,1991,West,61,985,258,Groceries,-221
09-10-2023 02:00,1757,2271,North,95,1837,862,Groceries,-514
09-10-2023 03:00,1135,2510,South,84,1304,678,Furniture,-1375
09-10-2023 04:00,1791,1712,North,85,746,833,Groceries,79
09-10-2023 05:00,4854,1643,West,87,1129,803,Electronics,3211
09-10-2023 06:00,1170,604,West,97,937,830,Groceries,566
09-10-2023 07:00,3206,1306,South,77,572,472,Electronics,1900
09-10-2023 08:00,3248,1564,East,62,1592,116,Clothing,1684
09-10-2023 09:00,4558,1388,North,61,1253,594,Electronics,3170
09-10-2023 10:00,2580,820,East,71,1675,718,Electronics,1760
09-10-2023 11:00,1961,2882,West,93,1330,565,Groceries,-921
09-10-2023 12:00,4847,2811,East,51,593,543,Groceries,2036
09-10-2023 13:00,3630,2000,North,78,934,838,Groceries,1630
09-10-2023 14:00,4575,2899,North,62,1954,180,Clothing,1676
09-10-2023 15:00,1875,2068,West,84,956,878,Furniture,-193
09-10-2023 16:00,3418,2296,South,62,1953,265,Electronics,1122
09-10-2023 17:00,1102,2019,South,83,728,456,Furniture,-917
09-10-2023 18:00,2001,2418,West,68,529,333,Furniture,-417
09-10-2023 19:00,2148,2365,North,58,834,261,Clothing,-217
09-10-2023 20:00,4384,1905,South,80,1159,274,Electronics,2479
09-10-2023 21:00,4023,2004,East,82,1068,771,Electronics,2019
09-10-2023 22:00,3845,2459,West,76,676,462,Clothing,1386
09-10-2023 23:00,2481,504,East,94,1323,475,Clothing,1977
10-10-2023 00:00,4301,2581,North,51,1067,796,Electronics,1720
10-10-2023 01:00,1657,1668,South,64,908,273,Clothing,-11
10-10-2023 02:00,3929,2898,North,68,1276,337,Groceries,1031
10-10-2023 03:00,2220,847,East,80,1760,262,Electronics,1373
10-10-2023 04:00,4956,2265,North,65,1801,337,Furniture,2691
10-10-2023 05:00,3780,624,North,92,576,717,Groceries,3156
10-10-2023 06:00,1422,2313,West,64,1432,729,Furniture,-891
10-10-2023 07:00,3619,2904,West,55,1135,331,Clothing,715
10-10-2023 08:00,4681,997,North,63,1039,687,Furniture,3684
10-10-2023 09:00,1170,1676,West,76,1681,616,Groceries,-506
10-10-2023 10:00,4453,552,North,87,1690,829,Clothing,3901
10-10-2023 11:00,3220,648,East,68,1708,893,Groceries,2572
10-10-2023 12:00,3710,1002,West,86,1912,944,Clothing,2708
10-10-2023 13:00,1452,1369,North,92,511,335,Electronics,83
10-10-2023 14:00,3397,718,West,53,668,422,Furniture,2679
10-10-2023 15:00,4973,1800,North,75,1330,643,Furniture,3173
10-10-2023 16:00,2975,2999,West,58,1949,506,Electronics,-24
10-10-2023 17:00,2657,2630,South,90,948,276,Electronics,27
10-10-2023 18:00,3541,1237,North,98,948,599,Furniture,2304
10-10-2023 19:00,3667,2951,South,89,1629,218,Electronics,716
10-10-2023 20:00,4075,789,North,64,926,289,Clothing,3286
10-10-2023 21:00,4164,2967,South,90,1455,713,Furniture,1197
10-10-2023 22:00,3966,838,North,86,1415,464,Groceries,3128
10-10-2023 23:00,3053,2193,West,53,1621,585,Electronics,860
11-10-2023 00:00,1287,2368,South,75,1130,178,Clothing,-1081
11-10-2023 01:00,2641,1486,West,67,725,421,Furniture,1155
11-10-2023 02:00,4217,1458,North,90,946,238,Furniture,2759
11-10-2023 03:00,4854,1730,West,84,1999,435,Clothing,3124
11-10-2023 04:00,2447,1788,North,90,702,501,Electronics,659
11-10-2023 05:00,2913,2506,West,90,1467,325,Furniture,407
11-10-2023 06:00,1607,872,South,78,1174,365,Electronics,735
11-10-2023 07:00,1456,2011,North,73,1820,432,Clothing,-555
11-10-2023 08:00,2764,1030,West,53,1133,323,Groceries,1734
11-10-2023 09:00,2225,1423,North,70,515,671,Clothing,802
11-10-2023 10:00,2235,522,North,88,1901,875,Electronics,1713
11-10-2023 11:00,2029,2651,North,56,1859,659,Furniture,-622
11-10-2023 12:00,3671,740,East,72,1117,692,Electronics,2931
11-10-2023 13:00,3423,1504,North,89,1543,908,Electronics,1919
11-10-2023 14:00,4962,2396,West,70,939,990,Groceries,2566
11-10-2023 15:00,1446,1665,East,50,1767,619,Furniture,-219
11-10-2023 16:00,1834,1313,West,90,1767,960,Groceries,521
11-10-2023 17:00,4177,1154,East,74,1470,348,Groceries,3023
11-10-2023 18:00,4722,1282,North,80,891,855,Clothing,3440
11-10-2023 19:00,1810,2854,South,93,1223,776,Clothing,-1044
11-10-2023 20:00,2424,507,South,87,1235,958,Furniture,1917
11-10-2023 21:00,4167,2214,North,94,1785,520,Groceries,1953
11-10-2023 22:00,2411,1074,East,54,719,931,Groceries,1337
11-10-2023 23:00,1958,1411,West,80,1531,286,Electronics,547
12-10-2023 00:00,2475,1017,South,50,945,348,Electronics,1458
12-10-2023 01:00,3896,2041,North,79,513,226,Clothing,1855
12-10-2023 02:00,1808,982,North,67,886,187,Groceries,826
12-10-2023 03:00,1978,2754,East,57,1141,144,Furniture,-776
12-10-2023 04:00,4972,1078,South,75,1545,893,Groceries,3894
12-10-2023 05:00,3463,886,North,89,724,345,Clothing,2577
12-10-2023 06:00,1725,911,South,64,734,510,Furniture,814
12-10-2023 07:00,4575,2365,West,68,1864,317,Groceries,2210
12-10-2023 08:00,3501,1893,North,59,1499,526,Electronics,1608
12-10-2023 09:00,4362,1876,North,73,1210,114,Groceries,2486
12-10-2023 10:00,4605,2467,West,65,1657,867,Clothing,2138
12-10-2023 11:00,2216,1859,North,92,1701,925,Clothing,357
12-10-2023 12:00,3197,1405,East,80,1291,788,Groceries,1792
12-10-2023 13:00,2903,1812,West,93,936,434,Clothing,1091
12-10-2023 14:00,3806,1462,East,65,1574,826,Electronics,2344
12-10-2023 15:00,1778,1464,West,65,1966,636,Electronics,314
12-10-2023 16:00,1972,2687,West,77,1080,591,Electronics,-715
12-10-2023 17:00,3810,2476,East,69,1804,935,Groceries,1334
12-10-2023 18:00,4049,2847,West,84,1567,391,Clothing,1202
12-10-2023 19:00,2538,1536,South,58,1186,216,Electronics,1002
12-10-2023 20:00,2416,1163,East,89,864,691,Furniture,1253
12-10-2023 21:00,4387,1324,West,59,768,786,Clothing,3063
12-10-2023 22:00,3123,2387,East,94,1816,843,Clothing,736
12-10-2023 23:00,1598,2947,West,67,1717,926,Furniture,-1349
13-10-2023 00:00,4341,1491,West,94,1894,568,Clothing,2850
13-10-2023 01:00,1224,1632,South,94,577,651,Electronics,-408
13-10-2023 02:00,2553,2696,South,64,688,782,Clothing,-143
13-10-2023 03:00,3160,2239,South,94,1913,728,Electronics,921
13-10-2023 04:00,3298,2854,West,79,1548,795,Electronics,444
13-10-2023 05:00,4304,1583,South,97,1825,692,Electronics,2721
13-10-2023 06:00,1840,934,East,81,1170,486,Groceries,906
13-10-2023 07:00,2814,520,West,89,857,682,Clothing,2294
13-10-2023 08:00,1713,2929,East,76,1458,751,Furniture,-1216
13-10-2023 09:00,2106,2792,South,76,1617,292,Groceries,-686
13-10-2023 10:00,1124,2425,West,68,835,782,Groceries,-1301
13-10-2023 11:00,4246,1972,East,59,1687,200,Groceries,2274
13-10-2023 12:00,2092,1599,North,93,1402,169,Groceries,493
13-10-2023 13:00,4118,889,East,95,840,273,Electronics,3229
13-10-2023 14:00,3931,1854,West,55,1333,543,Electronics,2077
13-10-2023 15:00,2279,2806,North,73,1066,800,Furniture,-527
13-10-2023 16:00,2750,925,South,58,571,532,Clothing,1825
13-10-2023 17:00,1029,2225,South,76,1565,314,Furniture,-1196
13-10-2023 18:00,3328,1529,East,56,910,636,Clothing,1799
13-10-2023 19:00,3971,505,South,55,1397,700,Electronics,3466
13-10-2023 20:00,3017,690,East,82,1337,742,Clothing,2327
13-10-2023 21:00,4308,647,East,70,1143,807,Clothing,3661
13-10-2023 22:00,4319,904,East,95,520,418,Groceries,3415
13-10-2023 23:00,3415,757,East,87,1524,385,Furniture,2658
14-10-2023 00:00,1494,2637,West,93,1177,324,Groceries,-1143
14-10-2023 01:00,4096,1323,West,66,1599,448,Groceries,2773
14-10-2023 02:00,2609,509,North,80,1102,487,Groceries,2100
14-10-2023 03:00,1717,1610,North,86,1921,945,Groceries,107
14-10-2023 04:00,4561,1337,South,60,587,440,Electronics,3224
14-10-2023 05:00,2016,1487,West,77,516,938,Furniture,529
14-10-2023 06:00,4565,1124,North,54,1852,760,Groceries,3441
14-10-2023 07:00,2337,529,West,61,1442,603,Furniture,1808
14-10-2023 08:00,1605,2675,West,52,1733,170,Groceries,-1070
14-10-2023 09:00,1374,2968,South,90,1323,228,Electronics,-1594
14-10-2023 10:00,3686,1578,South,87,882,543,Groceries,2108
14-10-2023 11:00,2960,2852,East,51,1139,389,Clothing,108
14-10-2023 12:00,2048,1045,West,75,1669,698,Electronics,1003
14-10-2023 13:00,2357,1628,East,51,952,486,Furniture,729
14-10-2023 14:00,4426,1695,East,61,1315,117,Clothing,2731
14-10-2023 15:00,1115,2022,East,89,1916,654,Clothing,-907
14-10-2023 16:00,3095,2569,West,51,809,175,Electronics,526
14-10-2023 17:00,4809,2938,West,90,1430,945,Furniture,1871
14-10-2023 18:00,2801,1116,East,65,991,652,Electronics,1685
14-10-2023 19:00,3146,648,West,79,1259,973,Groceries,2498
14-10-2023 20:00,2482,2311,East,96,1953,464,Electronics,171
14-10-2023 21:00,2546,2846,North,95,500,379,Electronics,-300
14-10-2023 22:00,2620,671,West,85,540,379,Groceries,1949
14-10-2023 23:00,3452,546,South,53,1171,870,Groceries,2906
15-10-2023 00:00,4285,1125,South,60,711,542,Furniture,3160
15-10-2023 01:00,1684,2310,East,73,1856,428,Electronics,-626
15-10-2023 02:00,3950,2754,North,67,1969,635,Groceries,1196
15-10-2023 03:00,3550,952,West,76,803,607,Furniture,2598
15-10-2023 04:00,4792,1918,East,86,1190,549,Furniture,2874
15-10-2023 05:00,2471,1253,North,51,1677,474,Groceries,1218
15-10-2023 06:00,3941,1508,North,64,1115,395,Groceries,2433
15-10-2023 07:00,2599,1633,West,60,1022,575,Furniture,966
15-10-2023 08:00,3305,1725,South,76,524,938,Clothing,1580
15-10-2023 09:00,3891,667,South,98,1307,492,Groceries,3224
15-10-2023 10:00,3168,585,North,97,524,208,Clothing,2583
15-10-2023 11:00,1809,2177,South,96,1095,458,Furniture,-368
15-10-2023 12:00,1977,2482,North,72,1629,388,Electronics,-505
15-10-2023 13:00,3101,1348,North,84,1642,517,Clothing,1753
15-10-2023 14:00,4066,1986,North,79,607,417,Clothing,2080
15-10-2023 15:00,2354,941,South,96,1853,440,Clothing,1413
15-10-2023 16:00,1783,770,East,73,679,416,Clothing,1013
15-10-2023 17:00,1240,2100,South,68,1380,448,Clothing,-860
15-10-2023 18:00,2778,843,East,78,630,126,Clothing,1935
15-10-2023 19:00,2553,1706,South,62,1102,737,Electronics,847
15-10-2023 20:00,1482,1757,West,97,1252,500,Electronics,-275
15-10-2023 21:00,2012,2791,West,72,1258,415,Electronics,-779
15-10-2023 22:00,1186,2032,South,61,667,781,Clothing,-846
15-10-2023 23:00,2881,766,West,98,722,658,Furniture,2115
16-10-2023 00:00,3703,2153,West,97,968,467,Groceries,1550
16-10-2023 01:00,3309,1392,West,90,777,442,Clothing,1917
16-10-2023 02:00,1952,2748,West,78,689,792,Electronics,-796
16-10-2023 03:00,2387,738,East,55,1030,464,Furniture,1649
16-10-2023 04:00,1490,1414,North,72,1120,172,Furniture,76
16-10-2023 05:00,1430,1938,East,80,1713,221,Clothing,-508
16-10-2023 06:00,1238,1960,North,94,717,964,Electronics,-722
16-10-2023 07:00,3351,2793,North,70,1822,285,Groceries,558
16-10-2023 08:00,3345,2381,South,73,1834,935,Groceries,964
16-10-2023 09:00,1075,2699,South,57,735,418,Electronics,-1624
16-10-2023 10:00,4771,1915,South,93,667,693,Electronics,2856
16-10-2023 11:00,2356,2758,South,58,1279,641,Furniture,-402
16-10-2023 12:00,2923,866,South,71,692,892,Clothing,2057
16-10-2023 13:00,4046,2093,East,53,741,732,Clothing,1953
16-10-2023 14:00,2781,585,East,62,1685,452,Clothing,2196
16-10-2023 15:00,3689,2236,West,83,1862,454,Groceries,1453
16-10-2023 16:00,4545,2157,East,52,1290,205,Groceries,2388
16-10-2023 17:00,1826,2541,East,86,954,923,Groceries,-715
16-10-2023 18:00,4994,2993,South,77,1658,517,Clothing,2001
16-10-2023 19:00,3330,1119,West,75,692,741,Electronics,2211
16-10-2023 20:00,1590,2851,East,99,1925,304,Electronics,-1261
16-10-2023 21:00,3119,631,East,95,891,664,Clothing,2488
16-10-2023 22:00,4334,1403,West,83,1100,481,Clothing,2931
16-10-2023 23:00,3750,1487,North,64,1565,396,Electronics,2263
17-10-2023 00:00,2902,1721,South,57,592,378,Electronics,1181
17-10-2023 01:00,2910,2594,East,97,1738,288,Groceries,316
17-10-2023 02:00,1574,2263,East,84,848,826,Furniture,-689
17-10-2023 03:00,4047,1726,West,73,1012,642,Furniture,2321
17-10-2023 04:00,1891,1784,East,86,1858,549,Clothing,107
17-10-2023 05:00,3059,1189,South,53,1922,357,Furniture,1870
17-10-2023 06:00,1140,1547,East,61,1423,552,Furniture,-407
17-10-2023 07:00,2789,1186,North,68,1687,671,Furniture,1603
17-10-2023 08:00,4626,1285,South,64,605,177,Groceries,3341
17-10-2023 09:00,1016,839,North,79,1755,122,Groceries,177
17-10-2023 10:00,2086,911,West,94,1491,602,Electronics,1175
17-10-2023 11:00,1252,2496,South,86,1216,284,Clothing,-1244
17-10-2023 12:00,1464,785,East,61,1700,646,Furniture,679
17-10-2023 13:00,1375,1609,South,68,1817,612,Electronics,-234
17-10-2023 14:00,2827,1349,South,83,1788,716,Groceries,1478
17-10-2023 15:00,4028,929,South,56,1287,787,Furniture,3099
17-10-2023 16:00,1519,2104,North,77,1793,148,Clothing,-585
17-10-2023 17:00,2860,530,West,77,1735,267,Furniture,2330
17-10-2023 18:00,1089,1102,South,78,1686,929,Groceries,-13
17-10-2023 19:00,1719,939,East,86,1322,882,Furniture,780
17-10-2023 20:00,3851,1484,South,69,1416,769,Furniture,2367
17-10-2023 21:00,3843,1872,South,60,1576,120,Furniture,1971
17-10-2023 22:00,1629,2418,West,99,1756,491,Furniture,-789
17-10-2023 23:00,2884,911,East,99,1961,204,Groceries,1973
18-10-2023 00:00,4246,1027,East,88,1353,389,Electronics,3219
18-10-2023 01:00,1075,809,North,91,1182,732,Furniture,266
18-10-2023 02:00,4684,2311,East,72,1522,803,Clothing,2373
18-10-2023 03:00,1925,1861,East,95,1450,525,Furniture,64
18-10-2023 04:00,4734,2538,East,69,543,328,Clothing,2196
18-10-2023 05:00,3447,2984,South,69,1102,280,Clothing,463
18-10-2023 06:00,2805,1203,North,60,1132,451,Furniture,1602
18-10-2023 07:00,1969,1162,East,51,591,324,Furniture,807
18-10-2023 08:00,2094,864,East,62,1258,333,Clothing,1230
18-10-2023 09:00,3028,1422,East,62,1230,365,Groceries,1606
18-10-2023 10:00,4251,2660,South,90,1453,957,Electronics,1591
18-10-2023 11:00,4195,675,South,98,1961,413,Clothing,3520
18-10-2023 12:00,2404,1672,North,64,836,598,Groceries,732
18-10-2023 13:00,4364,1701,West,80,1817,976,Electronics,2663
18-10-2023 14:00,3844,1435,North,72,1199,317,Electronics,2409
18-10-2023 15:00,1194,881,South,71,1424,310,Electronics,313
18-10-2023 16:00,4982,1782,East,65,1179,198,Furniture,3200
18-10-2023 17:00,1227,1712,East,91,1466,720,Furniture,-485
18-10-2023 18:00,4502,805,North,78,763,487,Clothing,3697
18-10-2023 19:00,2459,1901,East,69,604,444,Furniture,558
18-10-2023 20:00,4858,1101,South,77,723,352,Groceries,3757
18-10-2023 21:00,1460,2890,North,76,1942,623,Electronics,-1430
18-10-2023 22:00,1617,2703,West,93,1477,217,Electronics,-1086
18-10-2023 23:00,4092,1211,South,78,614,699,Electronics,2881
19-10-2023 00:00,1063,1965,South,54,1390,955,Furniture,-902
19-10-2023 01:00,3212,902,East,98,1758,308,Furniture,2310
19-10-2023 02:00,3074,1113,South,91,1797,508,Furniture,1961
19-10-2023 03:00,4382,2301,South,87,1753,580,Groceries,2081
19-10-2023 04:00,4059,676,West,87,1228,741,Furniture,3383
19-10-2023 05:00,1284,948,East,93,533,428,Furniture,336
19-10-2023 06:00,2683,1242,South,51,1911,282,Furniture,1441
19-10-2023 07:00,3328,2064,East,94,1394,516,Groceries,1264
19-10-2023 08:00,1837,2478,South,69,961,182,Furniture,-641
19-10-2023 09:00,1830,2848,West,92,948,353,Clothing,-1018
19-10-2023 10:00,2187,806,East,96,1328,104,Furniture,1381
19-10-2023 11:00,4969,1250,East,62,1737,402,Clothing,3719
19-10-2023 12:00,3965,1368,West,75,1569,635,Groceries,2597
19-10-2023 13:00,1223,713,North,84,904,732,Clothing,510
19-10-2023 14:00,1783,2117,South,95,832,706,Groceries,-334
19-10-2023 15:00,4217,2163,South,57,739,527,Furniture,2054
19-10-2023 16:00,4012,2097,North,77,1777,835,Furniture,1915
19-10-2023 17:00,1949,2680,East,90,727,850,Clothing,-731
19-10-2023 18:00,4939,2172,East,64,1232,326,Furniture,2767
19-10-2023 19:00,4101,1011,West,99,1390,753,Clothing,3090
19-10-2023 20:00,1044,2758,West,57,665,662,Groceries,-1714
19-10-2023 21:00,2810,1486,West,60,1084,489,Furniture,1324
19-10-2023 22:00,1470,752,North,78,1236,756,Furniture,718
19-10-2023 23:00,3081,537,North,54,1097,949,Furniture,2544
20-10-2023 00:00,3700,1128,East,96,1092,939,Electronics,2572
20-10-2023 01:00,4498,1486,West,96,1226,918,Electronics,3012
20-10-2023 02:00,1829,2225,East,56,1913,663,Clothing,-396
20-10-2023 03:00,2909,2593,North,67,1946,111,Electronics,316
20-10-2023 04:00,3268,1977,South,77,1424,436,Furniture,1291
20-10-2023 05:00,2891,2201,East,61,1934,706,Electronics,690
20-10-2023 06:00,3581,804,North,61,1148,982,Clothing,2777
20-10-2023 07:00,1691,2238,West,85,946,228,Electronics,-547
20-10-2023 08:00,2390,2780,South,78,1926,110,Groceries,-390
20-10-2023 09:00,1931,744,South,60,596,589,Groceries,1187
20-10-2023 10:00,1840,2244,South,55,878,371,Electronics,-404
20-10-2023 11:00,4814,2705,West,70,1169,456,Groceries,2109
20-10-2023 12:00,4058,1524,South,59,1709,980,Groceries,2534
20-10-2023 13:00,2938,716,North,81,1767,191,Electronics,2222
20-10-2023 14:00,2573,1006,East,96,1130,108,Groceries,1567
20-10-2023 15:00,3629,1260,South,82,1207,986,Clothing,2369
20-10-2023 16:00,4187,1553,South,66,1002,222,Clothing,2634
20-10-2023 17:00,3286,2404,North,52,787,875,Furniture,882
20-10-2023 18:00,4406,774,West,92,868,380,Clothing,3632
20-10-2023 19:00,3488,991,South,67,564,557,Furniture,2497
20-10-2023 20:00,1147,1326,North,59,661,550,Furniture,-179
20-10-2023 21:00,2032,1450,North,90,1096,730,Electronics,582
20-10-2023 22:00,2311,1678,West,88,1426,506,Groceries,633
20-10-2023 23:00,1387,1600,West,92,1070,801,Electronics,-213
21-10-2023 00:00,4121,2136,East,57,1473,890,Furniture,1985
21-10-2023 01:00,2873,1955,South,83,1161,911,Electronics,918
21-10-2023 02:00,4588,538,East,86,1941,155,Groceries,4050
21-10-2023 03:00,1915,2786,North,90,980,807,Groceries,-871
21-10-2023 04:00,2878,2669,South,82,768,478,Groceries,209
21-10-2023 05:00,3685,643,North,98,1235,601,Furniture,3042
21-10-2023 06:00,4658,2915,North,59,1066,122,Electronics,1743
21-10-2023 07:00,4748,1258,North,89,1713,876,Electronics,3490
21-10-2023 08:00,1277,746,West,67,905,344,Furniture,531
21-10-2023 09:00,2977,1264,West,74,1264,871,Furniture,1713
21-10-2023 10:00,2859,2922,South,91,1835,517,Clothing,-63
21-10-2023 11:00,4036,1814,North,90,1365,330,Electronics,2222
21-10-2023 12:00,4371,706,North,85,1617,309,Groceries,3665
21-10-2023 13:00,2825,2518,South,51,889,261,Electronics,307
21-10-2023 14:00,3636,2789,East,68,1046,476,Clothing,847
21-10-2023 15:00,2833,2849,North,59,1934,965,Groceries,-16
21-10-2023 16:00,3696,1817,West,98,1735,269,Clothing,1879
21-10-2023 17:00,1617,1200,East,52,1892,998,Furniture,417
21-10-2023 18:00,2630,787,East,68,1241,438,Furniture,1843
21-10-2023 19:00,3182,2701,East,75,1691,901,Electronics,481
21-10-2023 20:00,1579,2093,East,96,1537,573,Furniture,-514
21-10-2023 21:00,2170,2970,East,74,1085,326,Furniture,-800
21-10-2023 22:00,1489,1349,East,99,1373,972,Electronics,140
21-10-2023 23:00,3525,549,South,66,1730,462,Clothing,2976
22-10-2023 00:00,2182,1730,South,59,542,578,Clothing,452
22-10-2023 01:00,1383,2760,East,95,1379,654,Groceries,-1377
22-10-2023 02:00,1162,2408,West,99,1965,574,Groceries,-1246
22-10-2023 03:00,3488,2186,South,60,1410,294,Clothing,1302
22-10-2023 04:00,2876,2240,South,60,1106,111,Furniture,636
22-10-2023 05:00,2212,1843,East,61,1918,594,Groceries,369
22-10-2023 06:00,3462,2290,West,89,737,883,Clothing,1172
22-10-2023 07:00,2362,2460,East,97,1218,161,Furniture,-98
22-10-2023 08:00,2630,1588,West,57,1241,628,Furniture,1042
22-10-2023 09:00,2204,1655,West,73,903,370,Clothing,549
22-10-2023 10:00,1287,2881,North,63,713,637,Electronics,-1594
22-10-2023 11:00,2857,531,South,72,1345,656,Clothing,2326
22-10-2023 12:00,1186,1367,East,99,1897,997,Furniture,-181
22-10-2023 13:00,2907,1766,South,85,631,756,Groceries,1141
22-10-2023 14:00,2161,1715,South,66,508,164,Furniture,446
22-10-2023 15:00,1129,1665,West,94,652,961,Furniture,-536
22-10-2023 16:00,3241,2183,South,54,930,579,Clothing,1058
22-10-2023 17:00,3363,1100,North,52,982,897,Furniture,2263
22-10-2023 18:00,4856,2525,East,58,804,589,Electronics,2331
22-10-2023 19:00,2887,2084,South,69,783,167,Groceries,803
22-10-2023 20:00,1143,1487,East,99,971,461,Clothing,-344
22-10-2023 21:00,1015,1714,South,69,1492,911,Electronics,-699
22-10-2023 22:00,4373,2465,East,68,689,707,Groceries,1908
22-10-2023 23:00,3470,1939,East,70,1011,671,Electronics,1531
23-10-2023 00:00,1244,1019,East,65,842,868,Furniture,225
23-10-2023 01:00,1926,2258,South,82,1953,118,Furniture,-332
23-10-2023 02:00,4178,1368,North,54,1214,644,Electronics,2810
23-10-2023 03:00,4159,2563,East,73,1179,190,Groceries,1596
23-10-2023 04:00,3176,2331,West,64,1557,337,Electronics,845
23-10-2023 05:00,1906,1629,West,75,970,561,Electronics,277
23-10-2023 06:00,1886,782,West,93,1917,123,Electronics,1104
23-10-2023 07:00,1340,860,North,74,1240,326,Groceries,480
23-10-2023 08:00,3051,1558,East,77,1012,950,Electronics,1493
23-10-2023 09:00,4398,2660,North,82,1845,480,Furniture,1738
23-10-2023 10:00,2433,2855,East,95,1638,876,Clothing,-422
23-10-2023 11:00,4950,2434,North,67,1737,105,Furniture,2516
23-10-2023 12:00,1305,1458,East,67,644,669,Furniture,-153
23-10-2023 13:00,1907,1576,West,87,1058,711,Electronics,331
23-10-2023 14:00,3654,1604,East,82,1291,733,Clothing,2050
23-10-2023 15:00,4792,2139,North,76,1701,456,Electronics,2653
23-10-2023 16:00,4296,1892,East,98,859,256,Clothing,2404
23-10-2023 17:00,2371,2789,South,99,784,300,Furniture,-418
23-10-2023 18:00,4039,530,East,64,1768,324,Groceries,3509
23-10-2023 19:00,1320,1203,West,93,1264,562,Electronics,117
23-10-2023 20:00,1558,1368,East,62,1729,878,Furniture,190
23-10-2023 21:00,2204,1884,South,83,1083,762,Clothing,320
23-10-2023 22:00,3665,732,South,53,1865,356,Furniture,2933
23-10-2023 23:00,3758,1557,South,84,1226,692,Furniture,2201
24-10-2023 00:00,2409,1766,North,68,1883,530,Furniture,643
24-10-2023 01:00,2641,1450,South,80,1664,977,Groceries,1191
24-10-2023 02:00,4863,558,North,74,1459,524,Electronics,4305
24-10-2023 03:00,4843,801,South,89,1745,506,Electronics,4042
24-10-2023 04:00,2131,2545,North,61,1912,711,Electronics,-414
24-10-2023 05:00,3578,2659,South,61,1853,204,Groceries,919
24-10-2023 06:00,3457,2423,South,91,1242,351,Groceries,1034
24-10-2023 07:00,4367,816,East,74,1916,744,Clothing,3551
24-10-2023 08:00,1817,2388,South,82,1153,198,Electronics,-571
24-10-2023 09:00,2194,1668,East,86,857,277,Clothing,526
24-10-2023 10:00,4402,1189,South,77,1917,364,Furniture,3213
24-10-2023 11:00,3540,2381,South,92,1086,231,Clothing,1159
24-10-2023 12:00,4266,2453,East,58,539,298,Clothing,1813
24-10-2023 13:00,1011,517,East,63,1401,804,Furniture,494
24-10-2023 14:00,1194,1678,North,52,772,819,Furniture,-484
24-10-2023 15:00,3537,2029,West,54,1943,156,Clothing,1508
24-10-2023 16:00,3842,1277,East,75,1593,991,Clothing,2565
24-10-2023 17:00,3928,859,North,90,1328,508,Electronics,3069
24-10-2023 18:00,3229,831,South,67,1122,361,Groceries,2398
24-10-2023 19:00,4009,2441,East,87,957,841,Furniture,1568
24-10-2023 20:00,4888,1027,East,70,733,753,Clothing,3861
24-10-2023 21:00,1655,2559,South,88,696,674,Groceries,-904
24-10-2023 22:00,2921,1598,South,65,1035,217,Clothing,1323
24-10-2023 23:00,4387,711,South,89,1437,584,Electronics,3676
25-10-2023 00:00,3741,2214,South,72,646,420,Clothing,1527
25-10-2023 01:00,3077,2830,West,78,1073,407,Furniture,247
25-10-2023 02:00,2619,1553,East,59,1982,589,Clothing,1066
25-10-2023 03:00,4749,1532,South,54,1590,420,Clothing,3217
25-10-2023 04:00,4867,1832,South,60,529,856,Furniture,3035
25-10-2023 05:00,4864,1833,West,78,606,992,Electronics,3031
25-10-2023 06:00,2119,2973,East,94,889,455,Furniture,-854
25-10-2023 07:00,4452,2340,North,76,1378,747,Clothing,2112
25-10-2023 08:00,1777,2295,East,83,905,707,Electronics,-518
25-10-2023 09:00,1443,2227,North,63,1644,836,Furniture,-784
25-10-2023 10:00,1297,1090,West,90,1534,619,Groceries,207
25-10-2023 11:00,1807,2214,South,91,1083,625,Groceries,-407
25-10-2023 12:00,2760,2638,West,59,846,123,Groceries,122
25-10-2023 13:00,1844,955,East,91,1776,291,Furniture,889
25-10-2023 14:00,2015,943,South,60,1296,852,Electronics,1072
25-10-2023 15:00,2384,578,East,60,618,448,Furniture,1806
25-10-2023 16:00,2397,1998,North,84,1019,124,Clothing,399
25-10-2023 17:00,1553,1426,East,68,1738,489,Furniture,127
25-10-2023 18:00,3350,2650,West,73,1232,740,Groceries,700
25-10-2023 19:00,1420,1122,West,50,579,698,Groceries,298
25-10-2023 20:00,2269,1979,West,61,918,844,Clothing,290
25-10-2023 21:00,4791,733,South,96,1083,900,Furniture,4058
25-10-2023 22:00,2260,2117,East,63,1211,667,Groceries,143
25-10-2023 23:00,4605,2530,South,52,1812,289,Furniture,2075
26-10-2023 00:00,1184,886,East,94,733,127,Groceries,298
26-10-2023 01:00,1467,2134,North,99,760,640,Clothing,-667
26-10-2023 02:00,3801,537,East,81,1432,590,Electronics,3264
26-10-2023 03:00,3410,1684,East,65,1156,587,Electronics,1726
26-10-2023 04:00,2306,1985,East,87,1545,890,Groceries,321
26-10-2023 05:00,2576,2467,East,59,577,271,Groceries,109
26-10-2023 06:00,1335,1972,North,66,1241,137,Furniture,-637
26-10-2023 07:00,3209,740,South,98,1171,398,Electronics,2469
26-10-2023 08:00,4231,1549,West,89,1537,365,Furniture,2682
26-10-2023 09:00,2497,2171,East,53,1671,126,Groceries,326
26-10-2023 10:00,4672,1061,West,64,529,747,Electronics,3611
26-10-2023 11:00,4393,2499,West,82,937,847,Furniture,1894
26-10-2023 12:00,3059,1305,West,88,562,856,Groceries,1754
26-10-2023 13:00,2447,2429,West,59,1953,551,Furniture,18
26-10-2023 14:00,4144,2845,East,56,1658,568,Furniture,1299
26-10-2023 15:00,1587,1304,West,82,656,184,Groceries,283
26-10-2023 16:00,2881,2701,East,66,1068,112,Furniture,180
26-10-2023 17:00,1200,2175,North,61,1442,669,Furniture,-975
26-10-2023 18:00,1521,2596,South,66,1276,358,Electronics,-1075
26-10-2023 19:00,2887,2177,South,96,753,199,Furniture,710
26-10-2023 20:00,3552,545,East,65,1506,715,Clothing,3007
26-10-2023 21:00,4809,2151,East,63,1710,360,Groceries,2658
26-10-2023 22:00,2711,581,South,52,1372,377,Furniture,2130
26-10-2023 23:00,1787,2820,West,93,1902,165,Groceries,-1033
27-10-2023 00:00,4110,2941,East,99,1850,700,Clothing,1169
27-10-2023 01:00,1059,2309,West,79,698,907,Groceries,-1250
27-10-2023 02:00,1577,1289,East,95,1380,699,Clothing,288
27-10-2023 03:00,1320,1094,East,90,1694,477,Clothing,226
27-10-2023 04:00,2458,2605,North,84,1838,616,Electronics,-147
27-10-2023 05:00,4707,500,North,75,505,755,Clothing,4207
27-10-2023 06:00,4747,2763,South,61,1779,216,Electronics,1984
27-10-2023 07:00,4479,1996,North,80,1320,882,Furniture,2483
27-10-2023 08:00,3037,1265,North,66,1843,598,Electronics,1772
27-10-2023 09:00,1922,1170,South,86,747,304,Electronics,752
27-10-2023 10:00,2409,2101,West,57,503,686,Furniture,308
27-10-2023 11:00,2694,1414,North,68,1012,179,Groceries,1280
27-10-2023 12:00,1568,2344,West,75,1337,117,Groceries,-776
27-10-2023 13:00,2101,2495,South,53,1005,828,Furniture,-394
27-10-2023 14:00,4265,594,East,64,530,713,Clothing,3671
27-10-2023 15:00,4356,992,West,96,1798,743,Electronics,3364
27-10-2023 16:00,1526,649,South,63,1208,920,Groceries,877
27-10-2023 17:00,3571,1546,West,79,1385,157,Groceries,2025
27-10-2023 18:00,3660,1738,South,97,1848,211,Clothing,1922
27-10-2023 19:00,4227,898,South,91,1700,696,Groceries,3329
27-10-2023 20:00,4411,2957,East,73,1810,942,Groceries,1454
27-10-2023 21:00,3172,2678,West,95,1247,925,Groceries,494
27-10-2023 22:00,1870,1354,East,92,578,727,Furniture,516
27-10-2023 23:00,1279,2695,East,83,742,414,Groceries,-1416
28-10-2023 00:00,3964,880,West,68,1000,261,Groceries,3084
28-10-2023 01:00,4977,1051,West,52,704,897,Furniture,3926
28-10-2023 02:00,3669,794,South,53,1983,423,Groceries,2875
28-10-2023 03:00,3893,1643,West,60,1906,817,Clothing,2250
28-10-2023 04:00,2892,955,South,62,1222,430,Electronics,1937
28-10-2023 05:00,4729,2053,South,99,832,679,Furniture,2676
28-10-2023 06:00,2751,668,South,67,1102,998,Furniture,2083
28-10-2023 07:00,4981,1209,South,68,665,859,Groceries,3772
28-10-2023 08:00,1673,2446,South,93,660,601,Electronics,-773
28-10-2023 09:00,2151,2519,South,82,505,156,Clothing,-368
28-10-2023 10:00,3361,2584,West,87,704,264,Clothing,777
28-10-2023 11:00,1331,2221,West,52,1031,265,Electronics,-890
28-10-2023 12:00,2173,1784,North,98,1623,396,Electronics,389
28-10-2023 13:00,3039,2778,West,84,544,103,Clothing,261
28-10-2023 14:00,2477,753,East,50,956,509,Groceries,1724
28-10-2023 15:00,1035,2876,North,84,726,906,Electronics,-1841
28-10-2023 16:00,2708,1820,West,85,1838,976,Electronics,888
28-10-2023 17:00,2443,2557,East,87,551,205,Groceries,-114
28-10-2023 18:00,4093,2993,West,88,1669,719,Furniture,1100
28-10-2023 19:00,3253,2625,South,74,1804,781,Electronics,628
28-10-2023 20:00,3686,2740,North,89,1646,878,Groceries,946
28-10-2023 21:00,3895,900,South,62,970,878,Clothing,2995
28-10-2023 22:00,2379,2656,North,53,1396,665,Furniture,-277
28-10-2023 23:00,1439,2446,North,55,1820,265,Electronics,-1007
29-10-2023 00:00,3776,2810,South,60,1113,353,Groceries,966
29-10-2023 01:00,2119,2876,North,50,1011,887,Furniture,-757
29-10-2023 02:00,3988,862,North,57,1285,765,Groceries,3126
29-10-2023 03:00,1163,2806,West,83,1725,227,Clothing,-1643
29-10-2023 04:00,1147,1858,East,89,914,585,Electronics,-711
29-10-2023 05:00,4601,584,South,58,1113,175,Groceries,4017
29-10-2023 06:00,3341,2045,West,85,1945,986,Electronics,1296
29-10-2023 07:00,1194,2324,West,98,1019,320,Groceries,-1130
29-10-2023 08:00,1662,807,South,88,1173,881,Electronics,855
29-10-2023 09:00,1479,761,North,91,1596,533,Electronics,718
29-10-2023 10:00,4948,2421,South,86,844,734,Furniture,2527
29-10-2023 11:00,1122,1130,East,91,1550,636,Groceries,-8
29-10-2023 12:00,2423,1179,East,93,1692,538,Groceries,1244
29-10-2023 13:00,3746,1364,South,70,1274,534,Electronics,2382
29-10-2023 14:00,1964,2871,West,69,1084,717,Electronics,-907
29-10-2023 15:00,4523,2225,South,87,1732,717,Furniture,2298
29-10-2023 16:00,3708,2351,East,50,1379,714,Clothing,1357
29-10-2023 17:00,4175,1226,South,84,1397,877,Groceries,2949
29-10-2023 18:00,2778,1760,North,77,1347,625,Electronics,1018
29-10-2023 19:00,2485,2148,South,56,1224,232,Furniture,337
29-10-2023 20:00,4814,716,West,92,1156,540,Electronics,4098
29-10-2023 21:00,3014,1769,North,93,1110,633,Groceries,1245
29-10-2023 22:00,4789,947,East,58,1833,686,Furniture,3842
29-10-2023 23:00,1709,818,South,50,1523,896,Furniture,891
30-10-2023 00:00,3443,2409,West,85,1446,490,Electronics,1034
30-10-2023 01:00,1911,2584,West,83,679,343,Electronics,-673
30-10-2023 02:00,2360,1557,East,83,1146,867,Clothing,803
30-10-2023 03:00,4052,538,South,66,937,245,Clothing,3514
30-10-2023 04:00,4670,2102,West,81,894,514,Groceries,2568
30-10-2023 05:00,4213,2756,North,51,1093,526,Groceries,1457
30-10-2023 06:00,3364,1329,South,85,556,311,Furniture,2035
30-10-2023 07:00,2734,1355,East,74,1697,348,Groceries,1379
30-10-2023 08:00,4629,2358,North,92,825,134,Clothing,2271
30-10-2023 09:00,2823,1602,South,75,821,938,Clothing,1221
30-10-2023 10:00,4598,2000,West,94,682,352,Clothing,2598
30-10-2023 11:00,2579,2981,East,75,734,961,Electronics,-402
30-10-2023 12:00,4472,2320,East,70,1118,871,Clothing,2152
30-10-2023 13:00,1680,1341,South,67,1709,918,Clothing,339
30-10-2023 14:00,2333,2579,East,78,765,961,Groceries,-246
30-10-2023 15:00,3542,2940,North,73,1508,385,Clothing,602
30-10-2023 16:00,1555,1755,South,96,1341,961,Clothing,-200
30-10-2023 17:00,1609,2739,North,77,828,792,Electronics,-1130
30-10-2023 18:00,4844,2439,East,61,1888,309,Clothing,2405
30-10-2023 19:00,3156,769,East,60,1182,209,Groceries,2387
30-10-2023 20:00,4866,2624,East,76,523,429,Electronics,2242
30-10-2023 21:00,1371,1234,North,72,1784,241,Furniture,137
30-10-2023 22:00,3902,1383,East,82,1878,775,Clothing,2519
30-10-2023 23:00,1615,2831,South,65,695,186,Clothing,-1216
31-10-2023 00:00,3815,1612,West,77,1110,239,Clothing,2203
31-10-2023 01:00,2914,1148,South,77,1856,431,Furniture,1766
31-10-2023 02:00,3253,1679,West,94,1112,773,Electronics,1574
31-10-2023 03:00,1846,2797,East,87,1131,125,Electronics,-951
31-10-2023 04:00,1042,2642,South,55,820,745,Clothing,-1600
31-10-2023 05:00,1864,516,North,91,1970,968,Furniture,1348
31-10-2023 06:00,2268,616,West,78,1900,726,Groceries,1652
31-10-2023 07:00,4358,1482,North,83,702,792,Furniture,2876
31-10-2023 08:00,2378,2880,West,52,1613,461,Clothing,-502
31-10-2023 09:00,1784,2346,East,55,676,970,Furniture,-562
31-10-2023 10:00,1475,2045,South,97,1126,758,Electronics,-570
31-10-2023 11:00,1082,2663,West,87,531,459,Electronics,-1581
31-10-2023 12:00,2133,1462,South,62,1445,314,Electronics,671
31-10-2023 13:00,3237,1776,West,85,1226,176,Groceries,1461
31-10-2023 14:00,1799,1346,West,64,1453,194,Furniture,453
31-10-2023 15:00,1935,2863,East,55,1319,317,Clothing,-928
31-10-2023 16:00,4980,871,West,82,1290,974,Clothing,4109
31-10-2023 17:00,3298,2106,North,90,742,467,Electronics,1192
31-10-2023 18:00,4795,655,West,61,569,151,Clothing,4140
31-10-2023 19:00,3338,964,West,92,1514,373,Groceries,2374
31-10-2023 20:00,2668,1282,West,62,1594,543,Furniture,1386
31-10-2023 21:00,4272,1303,East,82,657,786,Groceries,2969
31-10-2023 22:00,4868,719,South,77,1048,924,Furniture,4149
31-10-2023 23:00,1325,2562,South,85,825,132,Furniture,-1237
01-11-2023 00:00,2534,2273,East,54,1558,971,Furniture,261
01-11-2023 01:00,4480,616,North,74,959,515,Clothing,3864
01-11-2023 02:00,4678,2878,North,66,915,743,Clothing,1800
01-11-2023 03:00,4861,2603,East,86,1070,524,Clothing,2258
01-11-2023 04:00,2985,1874,South,68,1385,886,Clothing,1111
01-11-2023 05:00,2964,2518,North,84,1942,106,Clothing,446
01-11-2023 06:00,1836,807,East,92,1010,594,Clothing,1029
01-11-2023 07:00,1507,721,South,83,867,838,Electronics,786
01-11-2023 08:00,3778,1696,North,95,1411,866,Electronics,2082
01-11-2023 09:00,4672,1296,North,55,1382,893,Electronics,3376
01-11-2023 10:00,3119,2029,East,68,706,847,Groceries,1090
01-11-2023 11:00,2270,650,South,50,1884,954,Groceries,1620
01-11-2023 12:00,1640,2220,North,56,1959,453,Groceries,-580
01-11-2023 13:00,4795,2056,East,83,1077,795,Furniture,2739
01-11-2023 14:00,3987,611,North,68,1793,298,Furniture,3376
01-11-2023 15:00,2878,1182,South,82,1756,814,Groceries,1696
01-11-2023 16:00,1607,1661,West,75,1168,534,Electronics,-54
01-11-2023 17:00,4658,2879,North,90,605,235,Clothing,1779
01-11-2023 18:00,2958,2065,South,98,1165,387,Clothing,893
01-11-2023 19:00,1565,1392,North,91,1541,901,Clothing,173
01-11-2023 20:00,2367,1830,West,76,759,757,Furniture,537
01-11-2023 21:00,4996,660,West,87,812,818,Groceries,4336
01-11-2023 22:00,3101,1925,North,75,1130,666,Electronics,1176
01-11-2023 23:00,2753,777,East,84,1625,910,Clothing,1976
02-11-2023 00:00,3575,2056,North,69,1036,507,Groceries,1519
02-11-2023 01:00,3658,996,South,73,1703,861,Groceries,2662
02-11-2023 02:00,4603,1895,East,96,1173,886,Furniture,2708
02-11-2023 03:00,2581,2415,South,70,1923,816,Furniture,166
02-11-2023 04:00,2986,1154,South,75,849,924,Furniture,1832
02-11-2023 05:00,3240,802,East,69,714,803,Furniture,2438
02-11-2023 06:00,4966,937,West,55,1906,435,Groceries,4029
02-11-2023 07:00,3105,685,South,52,1647,101,Furniture,2420
02-11-2023 08:00,4508,2089,North,59,1815,284,Clothing,2419
02-11-2023 09:00,4182,1172,West,61,827,773,Electronics,3010
02-11-2023 10:00,1128,1773,West,82,1346,660,Furniture,-645
02-11-2023 11:00,2872,1500,East,71,597,701,Clothing,1372
02-11-2023 12:00,1705,2826,North,65,1158,537,Electronics,-1121
02-11-2023 13:00,4996,1182,North,66,799,862,Furniture,3814
02-11-2023 14:00,1851,2218,West,59,529,121,Furniture,-367
02-11-2023 15:00,4397,1424,South,61,1597,311,Electronics,2973
02-11-2023 16:00,1007,2927,South,68,671,576,Clothing,-1920
02-11-2023 17:00,3076,1498,North,89,1517,565,Clothing,1578
02-11-2023 18:00,2135,784,West,72,1422,333,Groceries,1351
02-11-2023 19:00,3994,920,West,89,583,271,Groceries,3074
02-11-2023 20:00,4744,2660,West,59,1484,702,Furniture,2084
02-11-2023 21:00,3178,2775,East,59,1813,774,Clothing,403
02-11-2023 22:00,3235,1994,North,99,1138,896,Clothing,1241
02-11-2023 23:00,2698,1027,North,59,584,617,Furniture,1671
03-11-2023 00:00,3756,530,South,88,1777,343,Electronics,3226
03-11-2023 01:00,2498,661,South,79,1163,520,Electronics,1837
03-11-2023 02:00,4435,2341,North,53,1018,478,Groceries,2094
03-11-2023 03:00,4275,1204,North,50,1975,572,Furniture,3071
03-11-2023 04:00,3259,1221,South,92,1830,440,Electronics,2038
03-11-2023 05:00,2644,1901,North,68,683,770,Furniture,743
03-11-2023 06:00,1275,945,South,54,1472,222,Clothing,330
03-11-2023 07:00,4144,926,North,79,1837,971,Electronics,3218
03-11-2023 08:00,2702,2050,East,75,840,533,Electronics,652
03-11-2023 09:00,2795,2467,East,89,726,287,Electronics,328
03-11-2023 10:00,1242,1220,West,83,1336,113,Clothing,22
03-11-2023 11:00,4858,2301,North,51,763,169,Groceries,2557
03-11-2023 12:00,4173,2464,South,73,949,750,Furniture,1709
03-11-2023 13:00,4034,1557,North,63,1774,510,Electronics,2477
03-11-2023 14:00,3732,2544,North,90,1931,969,Clothing,1188
03-11-2023 15:00,1170,1235,West,91,669,936,Electronics,-65
03-11-2023 16:00,1652,1257,South,62,1065,690,Furniture,395
03-11-2023 17:00,2932,2295,North,78,631,905,Furniture,637
03-11-2023 18:00,3235,2143,South,50,1326,417,Electronics,1092
03-11-2023 19:00,4512,1253,North,95,1105,536,Clothing,3259
03-11-2023 20:00,2109,523,West,83,1569,691,Electronics,1586
03-11-2023 21:00,2499,1739,South,53,849,245,Clothing,760
03-11-2023 22:00,3099,554,North,77,598,984,Groceries,2545
03-11-2023 23:00,3158,1804,East,68,1560,836,Electronics,1354
04-11-2023 00:00,2972,2874,South,50,1961,326,Clothing,98
04-11-2023 01:00,3924,1469,West,85,1508,481,Electronics,2455
04-11-2023 02:00,4925,2733,East,92,574,279,Furniture,2192
04-11-2023 03:00,2066,933,South,62,557,635,Furniture,1133
04-11-2023 04:00,3258,707,South,99,1542,198,Electronics,2551
04-11-2023 05:00,3035,632,South,91,901,490,Electronics,2403
04-11-2023 06:00,4271,1862,South,54,687,369,Clothing,2409
04-11-2023 07:00,4881,1719,North,82,638,193,Clothing,3162
04-11-2023 08:00,1857,1785,North,63,642,891,Furniture,72
04-11-2023 09:00,4823,1805,South,65,607,562,Clothing,3018
04-11-2023 10:00,3674,868,West,81,720,880,Furniture,2806
04-11-2023 11:00,2049,1706,North,99,644,758,Groceries,343
04-11-2023 12:00,4990,2970,South,76,1357,384,Electronics,2020
04-11-2023 13:00,1298,2791,South,84,1009,121,Clothing,-1493
04-11-2023 14:00,4148,1281,West,52,875,101,Furniture,2867
04-11-2023 15:00,1923,1066,West,53,504,202,Furniture,857
04-11-2023 16:00,1136,1026,West,56,887,135,Electronics,110
04-11-2023 17:00,2043,536,East,62,1067,905,Electronics,1507
04-11-2023 18:00,3487,677,South,90,1483,373,Electronics,2810
04-11-2023 19:00,1210,1138,West,52,1059,150,Clothing,72
04-11-2023 20:00,3799,571,South,66,1686,242,Groceries,3228
04-11-2023 21:00,2574,2899,North,96,864,995,Groceries,-325
04-11-2023 22:00,3482,1672,South,59,916,582,Groceries,1810
04-11-2023 23:00,1779,2220,South,96,520,116,Groceries,-441
05-11-2023 00:00,2230,604,East,50,1113,979,Furniture,1626
05-11-2023 01:00,3486,2182,North,77,1016,688,Clothing,1304
05-11-2023 02:00,2802,720,North,59,1720,377,Groceries,2082
05-11-2023 03:00,3713,2349,East,56,1160,734,Groceries,1364
05-11-2023 04:00,2065,1362,West,88,1868,537,Clothing,703
05-11-2023 05:00,1410,798,West,52,829,535,Clothing,612
05-11-2023 06:00,4594,541,South,56,877,483,Electronics,4053
05-11-2023 07:00,3853,1270,East,58,1734,957,Electronics,2583
05-11-2023 08:00,3657,1962,West,89,659,785,Groceries,1695
05-11-2023 09:00,1426,2632,North,84,1157,231,Furniture,-1206
05-11-2023 10:00,4346,2209,East,75,853,362,Electronics,2137
05-11-2023 11:00,2471,1490,West,54,1763,493,Clothing,981
05-11-2023 12:00,3949,1210,North,62,578,882,Electronics,2739
05-11-2023 13:00,1941,708,East,94,651,307,Electronics,1233
05-11-2023 14:00,2907,1771,South,79,1016,907,Clothing,1136
05-11-2023 15:00,1741,1734,South,89,882,325,Groceries,7
05-11-2023 16:00,2392,538,North,99,1192,800,Electronics,1854
05-11-2023 17:00,2243,1775,West,88,851,564,Electronics,468
05-11-2023 18:00,2600,2326,West,59,1724,457,Groceries,274
05-11-2023 19:00,4938,1261,East,91,1450,243,Electronics,3677
05-11-2023 20:00,2255,1936,North,72,632,453,Furniture,319
05-11-2023 21:00,1327,1969,West,60,1133,350,Groceries,-642
05-11-2023 22:00,2466,2599,South,61,668,475,Furniture,-133
05-11-2023 23:00,3099,873,North,62,1365,344,Clothing,2226
06-11-2023 00:00,4957,1430,South,89,890,117,Furniture,3527
06-11-2023 01:00,2966,655,North,98,1908,814,Clothing,2311
06-11-2023 02:00,1375,2065,East,95,1319,815,Groceries,-690
06-11-2023 03:00,1262,1613,West,98,597,584,Clothing,-351
06-11-2023 04:00,1266,2898,West,65,1900,101,Clothing,-1632
06-11-2023 05:00,3406,2616,West,58,1491,475,Clothing,790
06-11-2023 06:00,4388,1765,South,59,1279,665,Clothing,2623
06-11-2023 07:00,4395,1153,West,78,839,265,Furniture,3242
06-11-2023 08:00,2944,562,North,58,631,964,Clothing,2382
06-11-2023 09:00,4979,1008,South,82,709,428,Clothing,3971
06-11-2023 10:00,4737,2839,East,73,1528,754,Electronics,1898
06-11-2023 11:00,2893,2187,South,84,876,547,Electronics,706
06-11-2023 12:00,2901,1947,East,60,1139,191,Electronics,954
06-11-2023 13:00,3699,2192,South,88,1577,619,Clothing,1507
06-11-2023 14:00,4634,1888,West,99,1721,351,Electronics,2746
06-11-2023 15:00,2652,2697,East,62,940,711,Furniture,-45
06-11-2023 16:00,2444,1794,West,72,1703,138,Groceries,650
06-11-2023 17:00,1045,2104,South,74,740,535,Groceries,-1059
06-11-2023 18:00,4892,1639,East,99,1843,747,Groceries,3253
06-11-2023 19:00,1599,1203,North,65,1000,461,Electronics,396
06-11-2023 20:00,1719,1015,North,97,522,661,Clothing,704
06-11-2023 21:00,2912,2437,South,70,1131,182,Groceries,475
06-11-2023 22:00,2292,2333,East,59,1516,865,Furniture,-41
06-11-2023 23:00,1600,1764,North,90,1703,807,Electronics,-164
07-11-2023 00:00,1380,529,West,89,674,126,Electronics,851
07-11-2023 01:00,1117,825,West,68,697,688,Furniture,292
07-11-2023 02:00,4637,515,South,84,1977,905,Clothing,4122
07-11-2023 03:00,3163,610,West,77,598,866,Clothing,2553
07-11-2023 04:00,4701,606,West,90,1244,120,Furniture,4095
07-11-2023 05:00,1259,2926,West,51,1950,317,Furniture,-1667
07-11-2023 06:00,2098,2709,North,79,952,144,Electronics,-611
07-11-2023 07:00,2503,782,East,89,1714,506,Furniture,1721
07-11-2023 08:00,3352,768,South,99,1473,793,Clothing,2584
07-11-2023 09:00,3054,1720,East,89,998,897,Clothing,1334
07-11-2023 10:00,1365,1766,East,54,1714,578,Clothing,-401
07-11-2023 11:00,2657,1097,East,87,640,962,Clothing,1560
07-11-2023 12:00,3570,1298,North,91,1272,755,Clothing,2272
07-11-2023 13:00,4419,1782,West,64,674,663,Electronics,2637
07-11-2023 14:00,2461,1672,South,85,919,862,Furniture,789
07-11-2023 15:00,3024,2390,East,52,1175,717,Furniture,634
07-11-2023 16:00,4286,2937,West,73,1957,908,Groceries,1349
07-11-2023 17:00,3476,2511,North,90,1963,810,Electronics,965
07-11-2023 18:00,1790,2963,East,97,1031,436,Electronics,-1173
07-11-2023 19:00,4569,925,West,97,1417,891,Electronics,3644
07-11-2023 20:00,4611,2225,North,96,860,247,Electronics,2386
07-11-2023 21:00,1746,2633,West,90,945,714,Electronics,-887
07-11-2023 22:00,3414,1739,South,98,1055,510,Clothing,1675
07-11-2023 23:00,1312,2970,West,61,1207,613,Groceries,-1658
08-11-2023 00:00,1537,617,West,57,1880,867,Clothing,920
08-11-2023 01:00,1920,2962,South,63,1060,671,Groceries,-1042
08-11-2023 02:00,2077,1098,South,67,1496,918,Electronics,979
08-11-2023 03:00,4612,2587,West,93,558,484,Electronics,2025
08-11-2023 04:00,2490,1684,South,95,1384,581,Furniture,806
08-11-2023 05:00,3912,2967,West,69,1690,702,Electronics,945
08-11-2023 06:00,4235,1163,East,72,1466,200,Electronics,3072
08-11-2023 07:00,3829,2642,West,54,1444,213,Electronics,1187
08-11-2023 08:00,3381,2081,North,50,762,361,Electronics,1300
08-11-2023 09:00,4618,1149,South,94,1954,521,Electronics,3469
08-11-2023 10:00,1797,1989,East,95,695,153,Groceries,-192
08-11-2023 11:00,1347,787,South,51,853,287,Furniture,560
08-11-2023 12:00,1272,2199,South,65,1385,638,Electronics,-927
08-11-2023 13:00,4010,911,South,54,1440,851,Electronics,3099
08-11-2023 14:00,1719,2947,North,71,1414,691,Electronics,-1228
08-11-2023 15:00,2773,1541,North,50,546,289,Groceries,1232
08-11-2023 16:00,4485,635,West,61,1252,930,Groceries,3850
08-11-2023 17:00,3547,2525,North,68,1832,966,Furniture,1022
08-11-2023 18:00,4164,1258,South,71,729,702,Electronics,2906
08-11-2023 19:00,1684,1771,East,91,1934,646,Furniture,-87
08-11-2023 20:00,3126,1524,East,93,1256,157,Clothing,1602
08-11-2023 21:00,1621,880,East,97,815,602,Groceries,741
08-11-2023 22:00,3039,2028,South,66,1261,288,Electronics,1011
08-11-2023 23:00,4288,1305,North,62,1600,864,Groceries,2983
09-11-2023 00:00,1946,975,East,88,561,647,Furniture,971
09-11-2023 01:00,3405,1453,South,77,737,969,Clothing,1952
09-11-2023 02:00,3665,1348,South,52,577,703,Electronics,2317
09-11-2023 03:00,1506,1396,East,54,1233,667,Groceries,110
09-11-2023 04:00,2582,531,East,85,1058,678,Clothing,2051
09-11-2023 05:00,4252,2427,West,64,1443,412,Furniture,1825
09-11-2023 06:00,3623,2665,West,66,1149,268,Furniture,958
09-11-2023 07:00,4317,690,South,93,1939,898,Groceries,3627
09-11-2023 08:00,1243,2270,West,95,1547,230,Groceries,-1027
09-11-2023 09:00,1505,2273,West,78,1552,777,Electronics,-768
09-11-2023 10:00,1421,2621,East,53,1658,663,Furniture,-1200
09-11-2023 11:00,4391,1122,West,81,850,251,Electronics,3269
09-11-2023 12:00,4158,1626,South,98,1412,204,Groceries,2532
09-11-2023 13:00,3264,1085,East,92,849,466,Clothing,2179
09-11-2023 14:00,4561,2967,West,87,1804,191,Electronics,1594
09-11-2023 15:00,4590,972,West,53,975,812,Furniture,3618
09-11-2023 16:00,4349,2287,West,62,791,904,Groceries,2062
09-11-2023 17:00,2872,613,North,69,1712,984,Groceries,2259
09-11-2023 18:00,4793,1902,West,96,1942,830,Electronics,2891
09-11-2023 19:00,4056,1836,West,67,1387,531,Electronics,2220
09-11-2023 20:00,2192,2877,South,98,967,678,Groceries,-685
09-11-2023 21:00,1329,838,West,91,1729,780,Electronics,491
09-11-2023 22:00,1649,2785,North,86,1765,404,Groceries,-1136
09-11-2023 23:00,2464,1696,East,61,805,127,Furniture,768
10-11-2023 00:00,1390,578,West,74,1707,387,Clothing,812
10-11-2023 01:00,2519,963,West,79,977,454,Electronics,1556
10-11-2023 02:00,1380,2421,South,64,1651,938,Furniture,-1041
10-11-2023 03:00,4377,2487,West,85,948,643,Furniture,1890
10-11-2023 04:00,1741,1061,West,57,729,777,Electronics,680
10-11-2023 05:00,3010,784,West,77,1564,503,Furniture,2226
10-11-2023 06:00,1819,722,West,71,1292,235,Groceries,1097
10-11-2023 07:00,1672,1789,East,98,1173,167,Electronics,-117
10-11-2023 08:00,3560,2190,South,87,1915,253,Clothing,1370
10-11-2023 09:00,2771,2920,East,65,1323,562,Groceries,-149
10-11-2023 10:00,3996,1756,North,54,1863,425,Furniture,2240
10-11-2023 11:00,2211,1327,West,95,1335,915,Furniture,884
10-11-2023 12:00,1929,2783,North,83,1544,195,Clothing,-854
10-11-2023 13:00,2539,1327,East,98,846,296,Clothing,1212
10-11-2023 14:00,1912,2460,North,87,509,207,Furniture,-548
10-11-2023 15:00,1643,2465,West,60,586,145,Clothing,-822
10-11-2023 16:00,1426,2927,North,51,1044,285,Clothing,-1501
10-11-2023 17:00,1501,1113,East,74,1372,553,Furniture,388
10-11-2023 18:00,1729,1062,West,74,1862,422,Groceries,667
10-11-2023 19:00,2283,2967,South,50,1214,384,Electronics,-684
10-11-2023 20:00,4584,2599,East,80,503,182,Furniture,1985
10-11-2023 21:00,3118,2244,West,54,1546,749,Clothing,874
10-11-2023 22:00,3525,2305,South,89,1720,426,Clothing,1220
10-11-2023 23:00,4249,2468,North,53,1400,848,Groceries,1781
11-11-2023 00:00,1456,2752,North,54,772,548,Furniture,-1296
11-11-2023 01:00,3236,1230,North,54,1974,420,Furniture,2006
11-11-2023 02:00,1290,756,West,65,1630,244,Clothing,534
11-11-2023 03:00,4591,684,North,67,1380,377,Furniture,3907
11-11-2023 04:00,4836,2692,North,92,1901,711,Clothing,2144
11-11-2023 05:00,1919,2531,South,66,1723,113,Clothing,-612
11-11-2023 06:00,3339,2213,South,84,1435,361,Clothing,1126
11-11-2023 07:00,2969,745,South,67,501,513,Electronics,2224
11-11-2023 08:00,1755,2734,West,53,1644,593,Clothing,-979
11-11-2023 09:00,2658,1365,East,80,648,146,Groceries,1293
11-11-2023 10:00,2834,2587,North,80,1447,836,Furniture,247
11-11-2023 11:00,2306,1100,North,58,651,755,Electronics,1206
11-11-2023 12:00,2567,1461,West,80,805,295,Furniture,1106
11-11-2023 13:00,2869,1941,North,54,1381,389,Groceries,928
11-11-2023 14:00,1376,2556,West,85,974,868,Electronics,-1180
11-11-2023 15:00,4729,2897,West,65,1887,531,Furniture,1832
11-11-2023 16:00,2179,2631,West,91,1306,619,Electronics,-452
11-11-2023 17:00,1507,1032,East,90,1594,889,Clothing,475
11-11-2023 18:00,2436,1488,West,65,532,423,Clothing,948
11-11-2023 19:00,3575,2542,East,69,1680,901,Furniture,1033
11-11-2023 20:00,4426,857,East,79,1853,528,Groceries,3569
11-11-2023 21:00,1558,877,North,75,1277,392,Electronics,681
11-11-2023 22:00,4834,2719,South,98,1910,476,Electronics,2115
11-11-2023 23:00,4258,1548,East,80,1682,634,Furniture,2710
12-11-2023 00:00,4102,892,East,99,1294,183,Clothing,3210
12-11-2023 01:00,3307,1626,South,64,1750,866,Electronics,1681
12-11-2023 02:00,1420,1201,East,90,1775,472,Clothing,219
12-11-2023 03:00,2552,1933,South,87,866,123,Clothing,619
12-11-2023 04:00,4622,1283,North,87,761,424,Groceries,3339
12-11-2023 05:00,1303,2328,West,92,1145,947,Clothing,-1025
12-11-2023 06:00,1941,2879,South,69,1037,415,Clothing,-938
12-11-2023 07:00,4110,1482,West,84,1566,649,Electronics,2628
12-11-2023 08:00,4560,1542,South,72,515,320,Groceries,3018
12-11-2023 09:00,4715,1671,West,93,604,313,Groceries,3044
12-11-2023 10:00,3589,2830,North,96,1290,571,Furniture,759
12-11-2023 11:00,4741,1361,East,88,1726,944,Furniture,3380
12-11-2023 12:00,2301,2376,North,74,1219,590,Furniture,-75
12-11-2023 13:00,4274,2335,East,99,1582,184,Groceries,1939
12-11-2023 14:00,2089,2198,West,71,1508,484,Clothing,-109
12-11-2023 15:00,3155,612,West,96,547,103,Groceries,2543
12-11-2023 16:00,3315,2185,East,57,1159,806,Clothing,1130
12-11-2023 17:00,3269,2122,South,58,1800,213,Furniture,1147
12-11-2023 18:00,2827,1922,North,64,1935,314,Furniture,905
12-11-2023 19:00,2553,1361,South,97,1701,435,Clothing,1192
12-11-2023 20:00,4161,2432,West,69,1300,976,Clothing,1729
12-11-2023 21:00,1692,1007,North,84,613,752,Furniture,685
12-11-2023 22:00,1254,2167,North,86,795,266,Clothing,-913
12-11-2023 23:00,2478,965,South,52,937,386,Groceries,1513
13-11-2023 00:00,3300,1621,East,83,765,594,Furniture,1679
13-11-2023 01:00,1256,789,East,83,661,483,Groceries,467
13-11-2023 02:00,3430,2262,North,85,1003,946,Furniture,1168
13-11-2023 03:00,1441,2709,East,84,1559,616,Electronics,-1268
13-11-2023 04:00,2881,2366,West,58,1086,226,Groceries,515
13-11-2023 05:00,3646,1216,South,79,957,532,Electronics,2430
13-11-2023 06:00,2113,1900,South,75,1505,185,Furniture,213
13-11-2023 07:00,4820,1066,South,61,1894,697,Groceries,3754
13-11-2023 08:00,3437,1973,North,73,771,635,Groceries,1464
13-11-2023 09:00,1581,1493,North,90,1702,144,Groceries,88
13-11-2023 10:00,4115,1640,East,68,979,722,Clothing,2475
13-11-2023 11:00,2735,2487,South,93,1456,389,Groceries,248
13-11-2023 12:00,4735,2493,West,65,658,796,Groceries,2242
13-11-2023 13:00,3645,2309,West,75,1254,334,Electronics,1336
13-11-2023 14:00,1018,1704,South,72,703,256,Groceries,-686
13-11-2023 15:00,2124,1458,North,82,1294,505,Clothing,666
13-11-2023 16:00,4985,2216,North,91,1801,772,Groceries,2769
13-11-2023 17:00,3654,1512,North,79,1666,604,Electronics,2142
13-11-2023 18:00,4837,2318,West,72,1011,811,Groceries,2519
13-11-2023 19:00,2380,1810,South,59,615,221,Groceries,570
13-11-2023 20:00,2565,974,West,85,891,323,Electronics,1591
13-11-2023 21:00,4832,1117,South,80,1866,976,Furniture,3715
13-11-2023 22:00,3080,1140,West,92,1896,122,Groceries,1940
13-11-2023 23:00,2993,2809,West,71,1187,296,Furniture,184
14-11-2023 00:00,4300,661,East,92,1429,578,Electronics,3639
14-11-2023 01:00,2547,2503,West,92,1225,384,Electronics,44
14-11-2023 02:00,4701,2482,South,87,868,617,Furniture,2219
14-11-2023 03:00,1861,2728,West,96,1738,407,Clothing,-867
14-11-2023 04:00,1154,1224,East,51,1068,444,Clothing,-70
14-11-2023 05:00,4494,968,East,72,1400,700,Electronics,3526
14-11-2023 06:00,1904,2309,South,84,1240,989,Clothing,-405
14-11-2023 07:00,2269,520,East,86,826,497,Clothing,1749
14-11-2023 08:00,1404,759,East,81,536,884,Electronics,645
14-11-2023 09:00,1843,1639,North,92,1485,563,Groceries,204
14-11-2023 10:00,2782,1936,South,61,879,895,Groceries,846
14-11-2023 11:00,2564,1036,East,84,1295,876,Groceries,1528
14-11-2023 12:00,2184,1451,East,90,1847,214,Clothing,733
14-11-2023 13:00,1746,2479,East,52,868,735,Furniture,-733
14-11-2023 14:00,2725,2340,South,83,723,549,Clothing,385
14-11-2023 15:00,4188,2356,North,87,1313,871,Groceries,1832
14-11-2023 16:00,1270,1350,West,73,1623,503,Electronics,-80
14-11-2023 17:00,1769,2471,North,87,1598,780,Electronics,-702
14-11-2023 18:00,2715,1780,South,66,1223,647,Electronics,935
14-11-2023 19:00,2510,1691,South,89,1960,328,Clothing,819
14-11-2023 20:00,4956,1032,South,50,1202,745,Furniture,3924
14-11-2023 21:00,1171,2562,West,57,1891,343,Groceries,-1391
14-11-2023 22:00,1273,2597,South,64,562,164,Electronics,-1324
14-11-2023 23:00,3306,803,North,99,598,336,Groceries,2503
15-11-2023 00:00,2158,915,East,94,1276,102,Groceries,1243
15-11-2023 01:00,2706,804,East,74,1748,599,Clothing,1902
15-11-2023 02:00,4793,2743,South,57,574,136,Electronics,2050
15-11-2023 03:00,2771,1312,South,81,683,720,Clothing,1459
15-11-2023 04:00,1421,2935,West,99,1816,349,Groceries,-1514
15-11-2023 05:00,2444,2484,East,62,1580,102,Groceries,-40
15-11-2023 06:00,2209,1212,West,95,1772,334,Groceries,997
15-11-2023 07:00,3411,2181,West,64,968,516,Electronics,1230
15-11-2023 08:00,4678,1833,West,55,639,350,Electronics,2845
15-11-2023 09:00,3425,674,West,82,858,242,Electronics,2751
15-11-2023 10:00,4594,1589,North,56,1931,859,Groceries,3005
15-11-2023 11:00,1579,1916,South,82,1997,155,Groceries,-337
15-11-2023 12:00,1890,2487,South,96,1969,160,Furniture,-597
15-11-2023 13:00,1721,2826,West,78,1479,167,Electronics,-1105
15-11-2023 14:00,4267,1257,West,87,1755,178,Groceries,3010
15-11-2023 15:00,1880,2910,North,86,799,426,Groceries,-1030
15-11-2023 16:00,2121,2272,West,93,925,466,Furniture,-151
15-11-2023 17:00,3652,670,North,81,1494,807,Furniture,2982
15-11-2023 18:00,3007,1574,North,52,660,806,Groceries,1433
15-11-2023 19:00,3069,1851,West,69,900,634,Electronics,1218
15-11-2023 20:00,2473,1164,South,63,1901,625,Clothing,1309
15-11-2023 21:00,4243,1091,North,77,1780,489,Clothing,3152
15-11-2023 22:00,1382,1668,South,87,1240,388,Clothing,-286
15-11-2023 23:00,3181,2821,South,53,1361,620,Electronics,360
16-11-2023 00:00,2449,2910,North,64,993,751,Groceries,-461
16-11-2023 01:00,4096,1848,East,66,988,853,Clothing,2248
16-11-2023 02:00,3550,1347,North,86,1705,352,Clothing,2203
16-11-2023 03:00,4256,2845,East,73,1025,838,Electronics,1411
16-11-2023 04:00,4156,993,North,87,1623,984,Groceries,3163
16-11-2023 05:00,2590,1045,North,91,1236,194,Groceries,1545
16-11-2023 06:00,2786,2851,South,90,857,790,Electronics,-65
16-11-2023 07:00,1143,1990,South,85,1754,102,Clothing,-847
16-11-2023 08:00,2886,1403,West,90,1064,795,Groceries,1483
16-11-2023 09:00,4981,2786,South,57,1529,145,Groceries,2195
16-11-2023 10:00,2702,2040,South,52,589,903,Clothing,662
16-11-2023 11:00,2435,1383,South,79,563,752,Electronics,1052
16-11-2023 12:00,1223,2957,South,71,1611,624,Clothing,-1734
16-11-2023 13:00,1219,2865,West,82,1556,797,Furniture,-1646
16-11-2023 14:00,1178,1404,South,74,1595,581,Groceries,-226
16-11-2023 15:00,2654,1119,East,79,752,696,Electronics,1535
16-11-2023 16:00,1432,1452,East,86,606,517,Clothing,-20
16-11-2023 17:00,1264,819,West,52,1429,142,Clothing,445
16-11-2023 18:00,1953,1375,South,53,1013,995,Electronics,578
16-11-2023 19:00,1428,2876,East,78,635,767,Groceries,-1448
16-11-2023 20:00,4733,2400,North,81,1128,795,Electronics,2333
16-11-2023 21:00,3463,1252,East,72,908,658,Furniture,2211
16-11-2023 22:00,4524,1879,South,68,620,305,Electronics,2645
16-11-2023 23:00,3774,1537,East,64,1299,821,Furniture,2237
17-11-2023 00:00,3244,570,North,65,1323,374,Groceries,2674
17-11-2023 01:00,2577,2335,East,72,1617,694,Clothing,242
17-11-2023 02:00,4124,2046,South,89,1004,196,Furniture,2078
17-11-2023 03:00,1479,605,North,95,506,278,Furniture,874
17-11-2023 04:00,4514,1269,West,86,1443,966,Electronics,3245
17-11-2023 05:00,2353,2509,North,50,690,247,Electronics,-156
17-11-2023 06:00,4322,2743,East,68,956,896,Clothing,1579
17-11-2023 07:00,4878,2692,West,86,885,483,Groceries,2186
17-11-2023 08:00,1889,1873,North,84,1302,171,Furniture,16
17-11-2023 09:00,4854,2209,North,79,1365,316,Clothing,2645
17-11-2023 10:00,1924,715,North,66,1522,820,Furniture,1209
17-11-2023 11:00,3170,1616,South,88,777,932,Clothing,1554
17-11-2023 12:00,2902,759,West,98,1971,905,Electronics,2143
17-11-2023 13:00,2410,1433,West,75,1326,532,Electronics,977
17-11-2023 14:00,2362,1074,North,62,1444,735,Groceries,1288
17-11-2023 15:00,1777,2064,West,71,551,600,Electronics,-287
17-11-2023 16:00,3395,2310,East,95,1928,961,Clothing,1085
17-11-2023 17:00,1028,784,East,72,895,767,Furniture,244
17-11-2023 18:00,4022,2454,North,93,1278,132,Clothing,1568
17-11-2023 19:00,1034,2919,East,92,1193,880,Groceries,-1885
17-11-2023 20:00,4589,569,North,82,710,315,Electronics,4020
17-11-2023 21:00,2419,878,East,76,1389,200,Electronics,1541
17-11-2023 22:00,3670,1802,North,84,769,569,Furniture,1868
17-11-2023 23:00,4365,2849,North,61,1044,279,Groceries,1516
18-11-2023 00:00,1588,754,West,58,1506,738,Groceries,834
18-11-2023 01:00,4420,2207,West,83,1344,432,Electronics,2213
18-11-2023 02:00,4218,1191,North,63,1515,587,Groceries,3027
18-11-2023 03:00,4138,1787,West,86,1805,559,Clothing,2351
18-11-2023 04:00,1903,1333,West,52,897,476,Groceries,570
18-11-2023 05:00,3567,2971,South,93,1739,780,Clothing,596
18-11-2023 06:00,3169,2760,East,93,1955,916,Clothing,409
18-11-2023 07:00,1339,2535,West,70,1844,977,Clothing,-1196
18-11-2023 08:00,1174,2467,North,56,1313,234,Electronics,-1293
18-11-2023 09:00,2923,599,South,82,1138,903,Clothing,2324
18-11-2023 10:00,2714,2352,South,84,992,704,Furniture,362
18-11-2023 11:00,1596,2855,West,60,1450,832,Groceries,-1259
18-11-2023 12:00,1450,2071,North,94,627,509,Clothing,-621
18-11-2023 13:00,1556,611,North,81,573,254,Furniture,945
18-11-2023 14:00,2159,682,North,71,1999,379,Electronics,1477
18-11-2023 15:00,4926,664,North,91,951,578,Electronics,4262
18-11-2023 16:00,4087,2637,North,68,1985,298,Electronics,1450
18-11-2023 17:00,2356,2523,East,85,937,948,Electronics,-167
18-11-2023 18:00,4266,954,North,86,1779,852,Groceries,3312
18-11-2023 19:00,4567,2785,North,60,947,516,Electronics,1782
18-11-2023 20:00,3056,2522,East,90,1625,197,Groceries,534
18-11-2023 21:00,4899,1226,West,62,1058,349,Furniture,3673
18-11-2023 22:00,3381,2605,South,77,1469,204,Electronics,776
18-11-2023 23:00,4404,1041,East,98,1436,872,Electronics,3363
19-11-2023 00:00,2016,2437,South,64,782,740,Furniture,-421
19-11-2023 01:00,3374,1521,South,62,1259,426,Furniture,1853
19-11-2023 02:00,3062,2949,East,92,1727,989,Groceries,113
19-11-2023 03:00,1838,1341,North,82,585,581,Clothing,497
19-11-2023 04:00,2637,2202,South,57,1847,870,Groceries,435
19-11-2023 05:00,1225,2189,North,81,663,903,Clothing,-964
19-11-2023 06:00,4496,1018,West,86,1376,476,Groceries,3478
19-11-2023 07:00,2813,696,East,97,1580,751,Clothing,2117
19-11-2023 08:00,4479,2593,South,53,705,114,Electronics,1886
19-11-2023 09:00,3160,1920,North,67,1952,999,Clothing,1240
19-11-2023 10:00,3020,2188,South,72,647,795,Furniture,832
19-11-2023 11:00,2451,1499,West,78,1824,580,Furniture,952
19-11-2023 12:00,3048,2621,West,51,1290,115,Clothing,427
19-11-2023 13:00,3313,2137,South,62,1813,832,Electronics,1176
19-11-2023 14:00,2514,2882,East,65,1544,674,Electronics,-368
19-11-2023 15:00,2231,2370,West,57,1446,852,Clothing,-139
19-11-2023 16:00,2645,1132,North,68,1660,584,Clothing,1513
19-11-2023 17:00,2735,1074,West,81,1892,378,Furniture,1661
19-11-2023 18:00,3999,2843,North,52,1056,432,Furniture,1156
19-11-2023 19:00,4440,1607,South,98,1959,356,Groceries,2833
19-11-2023 20:00,1305,1538,North,81,1260,284,Electronics,-233
19-11-2023 21:00,3059,2390,South,90,529,687,Electronics,669
19-11-2023 22:00,4416,977,West,70,1971,126,Electronics,3439
19-11-2023 23:00,4536,2866,East,74,724,124,Groceries,1670
20-11-2023 00:00,2723,2915,West,66,1909,953,Groceries,-192
20-11-2023 01:00,2689,866,West,74,928,161,Furniture,1823
20-11-2023 02:00,2517,2336,West,82,1028,757,Furniture,181
20-11-2023 03:00,2391,2925,West,80,1551,332,Clothing,-534
20-11-2023 04:00,4917,2215,East,85,625,563,Groceries,2702
20-11-2023 05:00,3984,2117,West,72,1312,448,Groceries,1867
20-11-2023 06:00,1419,512,North,96,998,385,Groceries,907
20-11-2023 07:00,3936,1035,East,93,1710,513,Electronics,2901
20-11-2023 08:00,4862,2817,East,74,1153,695,Furniture,2045
20-11-2023 09:00,3218,875,North,98,1895,786,Clothing,2343
20-11-2023 10:00,1133,2224,South,93,637,505,Groceries,-1091
20-11-2023 11:00,3030,756,West,97,1493,480,Groceries,2274
20-11-2023 12:00,4012,2764,East,79,1860,269,Groceries,1248
20-11-2023 13:00,2450,949,West,62,1240,389,Electronics,1501
20-11-2023 14:00,4096,1393,West,92,713,615,Clothing,2703
20-11-2023 15:00,2553,1684,North,96,790,386,Clothing,869
20-11-2023 16:00,4261,2579,North,78,1443,406,Groceries,1682
20-11-2023 17:00,2164,2347,North,65,870,661,Clothing,-183
20-11-2023 18:00,4626,1783,West,87,1029,881,Electronics,2843
20-11-2023 19:00,2869,1808,East,76,1191,107,Groceries,1061
20-11-2023 20:00,2819,1109,East,75,1048,456,Furniture,1710
20-11-2023 21:00,3705,1416,South,60,1819,680,Furniture,2289
20-11-2023 22:00,4386,2125,West,96,1273,238,Clothing,2261
20-11-2023 23:00,4515,647,South,86,1516,610,Furniture,3868
21-11-2023 00:00,2342,1155,South,52,918,347,Furniture,1187
21-11-2023 01:00,2464,2614,South,75,860,640,Groceries,-150
21-11-2023 02:00,4163,2316,South,83,1681,282,Electronics,1847
21-11-2023 03:00,3226,1802,South,82,1598,824,Groceries,1424
21-11-2023 04:00,2079,942,West,64,1895,522,Electronics,1137
21-11-2023 05:00,2178,898,North,51,1419,496,Groceries,1280
21-11-2023 06:00,2695,1651,South,77,1066,931,Furniture,1044
21-11-2023 07:00,1110,2733,East,69,1217,404,Groceries,-1623
21-11-2023 08:00,3184,2716,West,87,1226,118,Clothing,468
21-11-2023 09:00,3279,2207,South,93,1629,482,Clothing,1072
21-11-2023 10:00,4039,2487,East,65,866,325,Electronics,1552
21-11-2023 11:00,1467,2170,South,95,901,329,Electronics,-703
21-11-2023 12:00,3779,2081,North,53,602,950,Electronics,1698
21-11-2023 13:00,3528,1006,West,57,1286,707,Clothing,2522
21-11-2023 14:00,4139,660,North,93,824,594,Groceries,3479
21-11-2023 15:00,1813,839,East,95,872,583,Furniture,974
21-11-2023 16:00,2272,2325,South,69,837,726,Electronics,-53
21-11-2023 17:00,1993,1998,North,75,1390,458,Groceries,-5
21-11-2023 18:00,3031,2123,North,81,1556,791,Groceries,908
21-11-2023 19:00,1322,1986,South,62,1631,472,Clothing,-664
21-11-2023 20:00,3969,2006,West,54,1945,177,Clothing,1963
21-11-2023 21:00,1903,1676,East,93,1792,426,Furniture,227
21-11-2023 22:00,2541,1322,West,91,1596,375,Groceries,1219
21-11-2023 23:00,2999,1284,East,62,1704,451,Electronics,1715
22-11-2023 00:00,2815,630,East,90,1675,977,Clothing,2185
22-11-2023 01:00,4503,1975,North,60,1591,281,Groceries,2528
22-11-2023 02:00,4558,1999,South,86,1895,604,Clothing,2559
22-11-2023 03:00,3653,1280,West,81,1871,706,Groceries,2373
22-11-2023 04:00,3476,2207,North,94,1496,697,Clothing,1269
22-11-2023 05:00,4340,2269,North,91,531,488,Electronics,2071
22-11-2023 06:00,4780,1818,North,67,1426,706,Furniture,2962
22-11-2023 07:00,4608,2438,West,78,1119,434,Electronics,2170
22-11-2023 08:00,1147,1958,North,64,1602,545,Clothing,-811
22-11-2023 09:00,2141,875,South,69,1782,608,Clothing,1266
22-11-2023 10:00,1849,2751,North,93,1377,756,Clothing,-902
22-11-2023 11:00,1366,1160,North,85,674,347,Electronics,206
22-11-2023 12:00,3897,2622,East,54,1890,792,Clothing,1275
22-11-2023 13:00,2089,1903,North,89,514,392,Electronics,186
22-11-2023 14:00,3038,1240,West,86,1574,630,Clothing,1798
22-11-2023 15:00,3860,803,West,82,606,237,Furniture,3057
22-11-2023 16:00,4441,1585,South,67,968,655,Furniture,2856
22-11-2023 17:00,1174,1285,West,68,701,837,Clothing,-111
22-11-2023 18:00,2854,1710,West,81,1741,444,Groceries,1144
22-11-2023 19:00,1587,728,North,91,1564,136,Electronics,859
22-11-2023 20:00,1494,2354,South,71,1908,413,Clothing,-860
22-11-2023 21:00,4020,767,West,90,1416,319,Electronics,3253
22-11-2023 22:00,2137,753,South,50,835,739,Groceries,1384
22-11-2023 23:00,4182,1369,South,74,604,242,Furniture,2813
23-11-2023 00:00,2784,2634,East,69,702,503,Electronics,150
23-11-2023 01:00,4510,1704,East,84,1618,794,Electronics,2806
23-11-2023 02:00,4786,1548,North,94,1700,503,Electronics,3238
23-11-2023 03:00,2170,2769,West,55,564,654,Electronics,-599
23-11-2023 04:00,1034,1489,North,55,1052,578,Electronics,-455
23-11-2023 05:00,1998,896,North,99,723,821,Furniture,1102
23-11-2023 06:00,2332,1437,South,86,879,659,Electronics,895
23-11-2023 07:00,3585,939,South,98,754,923,Electronics,2646
23-11-2023 08:00,3797,2427,South,52,1821,319,Furniture,1370
23-11-2023 09:00,2037,2858,North,86,670,466,Clothing,-821
23-11-2023 10:00,1373,2507,West,80,1112,295,Clothing,-1134
23-11-2023 11:00,3604,534,North,84,1151,783,Electronics,3070
23-11-2023 12:00,2451,2764,North,94,1217,848,Furniture,-313
23-11-2023 13:00,2751,1220,North,64,1331,786,Electronics,1531
23-11-2023 14:00,3280,1018,East,66,1887,131,Clothing,2262
23-11-2023 15:00,1704,768,East,64,1318,835,Furniture,936
23-11-2023 16:00,1562,1137,West,54,572,153,Groceries,425
23-11-2023 17:00,3986,1848,East,71,1583,522,Furniture,2138
23-11-2023 18:00,3934,1879,North,95,954,797,Clothing,2055
23-11-2023 19:00,3773,589,East,60,835,333,Furniture,3184
23-11-2023 20:00,4734,1565,East,77,1167,928,Groceries,3169
23-11-2023 21:00,4511,1888,North,63,1647,842,Furniture,2623
23-11-2023 22:00,4573,2194,West,88,1978,209,Electronics,2379
23-11-2023 23:00,4346,1889,East,52,513,978,Electronics,2457
24-11-2023 00:00,2873,2835,North,91,1939,199,Clothing,38
24-11-2023 01:00,3123,980,North,60,526,811,Furniture,2143
24-11-2023 02:00,1438,1000,North,79,1573,310,Clothing,438
24-11-2023 03:00,4803,2161,South,87,686,832,Furniture,2642
24-11-2023 04:00,2883,2599,North,54,1580,502,Clothing,284
24-11-2023 05:00,2979,602,East,71,1270,936,Furniture,2377
24-11-2023 06:00,1698,1947,East,62,1166,249,Electronics,-249
24-11-2023 07:00,2312,2463,North,93,1489,774,Clothing,-151
24-11-2023 08:00,3962,2139,South,70,1557,493,Clothing,1823
24-11-2023 09:00,2563,1827,South,86,1037,754,Groceries,736
24-11-2023 10:00,3938,2974,South,74,1435,357,Furniture,964
24-11-2023 11:00,1691,2179,East,70,870,344,Electronics,-488
24-11-2023 12:00,3300,2657,South,77,585,249,Electronics,643
24-11-2023 13:00,4197,2088,West,90,659,723,Electronics,2109
24-11-2023 14:00,2200,567,West,53,924,198,Clothing,1633
24-11-2023 15:00,4108,2936,South,78,1629,202,Electronics,1172
24-11-2023 16:00,3457,2173,West,96,1914,822,Clothing,1284
24-11-2023 17:00,2634,807,North,84,774,111,Groceries,1827
24-11-2023 18:00,2633,1875,South,72,1812,992,Electronics,758
24-11-2023 19:00,1126,2322,South,56,757,325,Groceries,-1196
24-11-2023 20:00,2506,1589,South,95,1462,912,Furniture,917
24-11-2023 21:00,2191,959,North,95,1743,541,Furniture,1232
24-11-2023 22:00,3639,2894,North,58,1473,247,Groceries,745
24-11-2023 23:00,1293,2872,South,72,1026,278,Furniture,-1579
25-11-2023 00:00,4916,1166,East,52,1032,106,Electronics,3750
25-11-2023 01:00,4709,2122,East,58,1582,251,Electronics,2587
25-11-2023 02:00,2366,1556,West,53,1883,934,Clothing,810
25-11-2023 03:00,2019,567,North,98,612,681,Groceries,1452
25-11-2023 04:00,3357,2734,West,74,1799,452,Groceries,623
25-11-2023 05:00,3709,2739,West,55,756,664,Clothing,970
25-11-2023 06:00,3575,1736,South,97,828,773,Electronics,1839
25-11-2023 07:00,3587,2123,East,67,1276,516,Groceries,1464
25-11-2023 08:00,1418,2975,West,94,1758,704,Clothing,-1557
25-11-2023 09:00,1443,1874,South,56,550,762,Groceries,-431
25-11-2023 10:00,1684,2763,North,84,720,669,Groceries,-1079
25-11-2023 11:00,4629,676,West,80,1282,295,Clothing,3953
25-11-2023 12:00,3887,2088,East,87,1095,424,Groceries,1799
25-11-2023 13:00,3283,1853,North,81,1753,581,Furniture,1430
25-11-2023 14:00,2462,1125,South,84,721,307,Clothing,1337
25-11-2023 15:00,3261,678,North,77,1442,402,Clothing,2583
25-11-2023 16:00,1084,894,West,93,1577,398,Furniture,190
25-11-2023 17:00,3841,1668,North,54,1796,525,Groceries,2173
25-11-2023 18:00,2767,1375,North,79,697,161,Furniture,1392
25-11-2023 19:00,1084,1461,North,71,627,294,Groceries,-377
25-11-2023 20:00,2944,697,East,66,1532,666,Electronics,2247
25-11-2023 21:00,4560,1468,West,59,1486,462,Furniture,3092
25-11-2023 22:00,3112,1168,South,56,726,660,Furniture,1944
25-11-2023 23:00,2669,1776,East,53,1057,717,Furniture,893
26-11-2023 00:00,1662,2410,West,91,1657,177,Electronics,-748
26-11-2023 01:00,1626,571,South,76,1539,986,Groceries,1055
26-11-2023 02:00,1063,722,South,56,714,383,Electronics,341
26-11-2023 03:00,4414,2823,South,72,1635,156,Furniture,1591
26-11-2023 04:00,3986,1769,West,60,1354,780,Electronics,2217
26-11-2023 05:00,4946,1864,South,57,1680,475,Furniture,3082
26-11-2023 06:00,1918,1423,South,57,924,475,Clothing,495
26-11-2023 07:00,2375,970,East,86,1975,818,Groceries,1405
26-11-2023 08:00,2181,2554,South,54,817,871,Furniture,-373
26-11-2023 09:00,2612,687,North,56,859,887,Electronics,1925
26-11-2023 10:00,1490,2551,East,71,1899,472,Electronics,-1061
26-11-2023 11:00,4729,2168,East,85,1435,956,Electronics,2561
26-11-2023 12:00,2878,1648,West,51,1457,774,Groceries,1230
26-11-2023 13:00,4534,1459,South,73,1419,343,Clothing,3075
26-11-2023 14:00,4296,1129,North,51,1401,861,Groceries,3167
26-11-2023 15:00,2940,1274,North,97,1819,920,Clothing,1666
26-11-2023 16:00,1312,859,South,61,697,138,Electronics,453
26-11-2023 17:00,3662,1017,South,96,897,408,Groceries,2645
26-11-2023 18:00,1918,1843,West,91,1089,732,Clothing,75
26-11-2023 19:00,2882,2469,North,75,741,185,Electronics,413
26-11-2023 20:00,1812,1420,East,87,928,198,Electronics,392
26-11-2023 21:00,3987,1434,West,94,1110,473,Groceries,2553
26-11-2023 22:00,2489,2486,West,55,505,857,Clothing,3
26-11-2023 23:00,4159,1400,East,72,1841,594,Electronics,2759
27-11-2023 00:00,4954,2228,West,51,1735,959,Electronics,2726
27-11-2023 01:00,2326,2946,South,75,1796,307,Electronics,-620
27-11-2023 02:00,1679,1869,East,63,1607,724,Furniture,-190
27-11-2023 03:00,1434,1718,East,67,1209,182,Clothing,-284
27-11-2023 04:00,1681,2715,North,87,859,676,Clothing,-1034
27-11-2023 05:00,2158,876,East,81,1904,100,Furniture,1282
27-11-2023 06:00,2073,2274,West,63,1664,536,Electronics,-201
27-11-2023 07:00,2455,2005,North,79,1696,785,Furniture,450
27-11-2023 08:00,3387,1767,West,62,1543,349,Furniture,1620
27-11-2023 09:00,3394,1510,South,89,1002,509,Furniture,1884
27-11-2023 10:00,3693,1694,South,80,726,837,Clothing,1999
27-11-2023 11:00,2370,1730,North,86,608,485,Electronics,640
27-11-2023 12:00,1648,1677,North,94,1242,895,Electronics,-29
27-11-2023 13:00,1244,2595,West,87,1843,183,Clothing,-1351
27-11-2023 14:00,3156,2172,South,71,1831,589,Clothing,984
27-11-2023 15:00,4896,2428,North,77,1310,338,Furniture,2468
27-11-2023 16:00,4870,672,South,68,1610,639,Furniture,4198
27-11-2023 17:00,3580,2945,South,92,1285,479,Groceries,635
27-11-2023 18:00,4161,793,South,65,727,898,Groceries,3368
27-11-2023 19:00,1295,1051,West,54,1351,490,Clothing,244
27-11-2023 20:00,3159,1970,West,93,1833,427,Furniture,1189
27-11-2023 21:00,4884,1539,South,98,1327,579,Clothing,3345
27-11-2023 22:00,2612,2162,South,51,878,403,Furniture,450
27-11-2023 23:00,4248,1384,South,59,884,381,Furniture,2864
28-11-2023 00:00,3390,1872,East,96,612,794,Clothing,1518
28-11-2023 01:00,4731,1726,East,68,1816,444,Clothing,3005
28-11-2023 02:00,3148,633,West,69,1828,234,Electronics,2515
28-11-2023 03:00,4829,1270,South,78,790,567,Electronics,3559
28-11-2023 04:00,3676,1589,East,74,1628,460,Groceries,2087
28-11-2023 05:00,2627,979,North,66,790,668,Clothing,1648
28-11-2023 06:00,4472,1362,North,62,1176,214,Groceries,3110
28-11-2023 07:00,1027,958,South,94,559,285,Clothing,69
28-11-2023 08:00,3984,1125,East,65,1835,577,Clothing,2859
28-11-2023 09:00,2985,658,North,84,605,987,Clothing,2327
28-11-2023 10:00,2560,2708,West,85,1122,100,Electronics,-148
28-11-2023 11:00,1057,1777,North,88,588,949,Groceries,-720
28-11-2023 12:00,2521,2507,West,52,1791,640,Clothing,14
28-11-2023 13:00,1296,2420,North,58,1241,843,Groceries,-1124
28-11-2023 14:00,3181,1439,North,89,1642,761,Groceries,1742
28-11-2023 15:00,4402,2072,East,99,1399,523,Electronics,2330
28-11-2023 16:00,3296,2702,North,95,944,801,Electronics,594
28-11-2023 17:00,4068,931,North,78,1952,369,Clothing,3137
28-11-2023 18:00,3597,1550,West,54,1506,859,Furniture,2047
28-11-2023 19:00,1901,1503,West,52,1874,997,Groceries,398
28-11-2023 20:00,2964,2614,North,59,805,518,Electronics,350
28-11-2023 21:00,2098,2643,South,80,1114,426,Groceries,-545
28-11-2023 22:00,2677,714,North,60,701,294,Furniture,1963
28-11-2023 23:00,3881,2741,North,66,1443,992,Groceries,1140
29-11-2023 00:00,2191,2170,East,89,1546,354,Clothing,21
29-11-2023 01:00,1770,1813,North,90,1613,178,Groceries,-43
29-11-2023 02:00,2526,1384,North,57,970,974,Electronics,1142
29-11-2023 03:00,4956,2586,West,51,1616,197,Clothing,2370
29-11-2023 04:00,2378,2387,West,53,1478,249,Clothing,-9
29-11-2023 05:00,2248,1438,West,65,1808,885,Furniture,810
29-11-2023 06:00,4735,1438,West,90,808,913,Clothing,3297
29-11-2023 07:00,2554,705,North,90,1232,949,Electronics,1849
29-11-2023 08:00,1145,1441,South,70,1035,546,Furniture,-296
29-11-2023 09:00,2983,1054,East,54,875,222,Clothing,1929
29-11-2023 10:00,2264,2019,East,84,998,709,Furniture,245
29-11-2023 11:00,2907,1270,South,63,1135,775,Groceries,1637
29-11-2023 12:00,3940,748,South,64,641,657,Clothing,3192
29-11-2023 13:00,3391,1597,East,55,1575,458,Electronics,1794
29-11-2023 14:00,2772,872,North,65,1593,338,Electronics,1900
29-11-2023 15:00,2058,2354,East,72,759,841,Clothing,-296
29-11-2023 16:00,3749,1334,South,80,1816,904,Groceries,2415
29-11-2023 17:00,3048,1201,North,91,877,855,Furniture,1847
29-11-2023 18:00,3019,2685,East,95,1562,629,Electronics,334
29-11-2023 19:00,1152,1441,North,61,847,782,Electronics,-289
29-11-2023 20:00,3476,2991,North,90,1327,971,Furniture,485
29-11-2023 21:00,1507,2900,South,68,1005,768,Furniture,-1393
29-11-2023 22:00,4197,1495,West,61,881,303,Electronics,2702
29-11-2023 23:00,1490,1293,East,94,924,757,Furniture,197
30-11-2023 00:00,4553,2958,South,62,1959,242,Clothing,1595
30-11-2023 01:00,1344,1177,East,98,821,286,Electronics,167
30-11-2023 02:00,2935,2313,West,51,749,587,Electronics,622
30-11-2023 03:00,2761,2061,West,69,679,221,Electronics,700
30-11-2023 04:00,1220,952,West,80,1503,449,Clothing,268
30-11-2023 05:00,2938,2966,West,58,528,199,Electronics,-28
30-11-2023 06:00,2942,2997,East,70,1849,383,Furniture,-55
30-11-2023 07:00,1722,1638,North,57,1237,626,Electronics,84
30-11-2023 08:00,4096,550,North,88,686,483,Clothing,3546
30-11-2023 09:00,1527,1892,West,86,554,654,Clothing,-365
30-11-2023 10:00,4253,2038,West,78,1377,900,Groceries,2215
30-11-2023 11:00,2522,709,North,68,1013,997,Electronics,1813
30-11-2023 12:00,3888,1387,South,84,1933,286,Clothing,2501
30-11-2023 13:00,2664,2426,West,94,516,107,Groceries,238
30-11-2023 14:00,4113,1349,North,87,587,723,Electronics,2764
30-11-2023 15:00,4986,2377,South,75,1746,644,Clothing,2609
30-11-2023 16:00,1480,1126,North,60,1581,518,Clothing,354
30-11-2023 17:00,3977,1958,South,85,1203,189,Electronics,2019
30-11-2023 18:00,2871,1750,East,84,1224,595,Electronics,1121
30-11-2023 19:00,4819,1162,South,53,1753,760,Groceries,3657
30-11-2023 20:00,3919,767,West,52,1677,823,Electronics,3152
30-11-2023 21:00,2462,2663,South,94,1796,215,Electronics,-201
30-11-2023 22:00,2425,2123,South,96,1569,784,Furniture,302
30-11-2023 23:00,4617,2353,West,61,1394,119,Electronics,2264
01-12-2023 00:00,1344,1253,East,81,951,990,Clothing,91
01-12-2023 01:00,4964,1852,South,96,1829,231,Groceries,3112
01-12-2023 02:00,1044,2368,East,75,926,391,Groceries,-1324
01-12-2023 03:00,4717,1563,North,92,617,453,Groceries,3154
01-12-2023 04:00,3068,681,North,92,1187,336,Clothing,2387
01-12-2023 05:00,2657,2013,West,62,1521,688,Electronics,644
01-12-2023 06:00,4141,1402,East,93,1079,322,Clothing,2739
01-12-2023 07:00,2887,1642,West,87,750,535,Furniture,1245
01-12-2023 08:00,3920,2805,West,78,902,737,Groceries,1115
01-12-2023 09:00,3095,2006,South,68,1420,138,Electronics,1089
01-12-2023 10:00,2514,2639,North,84,699,426,Electronics,-125
01-12-2023 11:00,3598,2502,West,97,1669,308,Groceries,1096
01-12-2023 12:00,3334,1684,South,90,1574,205,Furniture,1650
01-12-2023 13:00,2001,648,South,76,1413,751,Furniture,1353
01-12-2023 14:00,2033,2664,East,95,1891,348,Electronics,-631
01-12-2023 15:00,3589,2592,North,80,819,666,Clothing,997
01-12-2023 16:00,3040,2300,East,52,698,729,Groceries,740
01-12-2023 17:00,3803,2521,East,84,1964,961,Clothing,1282
01-12-2023 18:00,1273,2342,West,73,644,787,Electronics,-1069
01-12-2023 19:00,1955,2536,East,56,1582,453,Groceries,-581
01-12-2023 20:00,3647,2781,West,84,642,569,Furniture,866
01-12-2023 21:00,2779,1898,East,70,1746,824,Furniture,881
01-12-2023 22:00,1380,2070,South,50,1623,364,Furniture,-690
01-12-2023 23:00,2352,2373,North,93,1549,751,Electronics,-21
02-12-2023 00:00,1478,2472,North,55,1955,563,Furniture,-994
02-12-2023 01:00,3062,2744,North,88,1025,936,Groceries,318
02-12-2023 02:00,1515,2572,South,83,621,950,Groceries,-1057
02-12-2023 03:00,1190,2942,South,67,1988,540,Groceries,-1752
02-12-2023 04:00,2191,1213,East,74,764,383,Groceries,978
02-12-2023 05:00,4592,2308,East,64,1530,884,Furniture,2284
02-12-2023 06:00,3668,722,East,96,1230,633,Groceries,2946
02-12-2023 07:00,2160,1363,East,81,1743,468,Electronics,797
02-12-2023 08:00,3201,1029,North,91,895,798,Groceries,2172
02-12-2023 09:00,2411,1711,East,98,1412,818,Furniture,700
02-12-2023 10:00,4280,1925,South,99,1980,758,Furniture,2355
02-12-2023 11:00,1271,2804,South,67,607,594,Clothing,-1533
02-12-2023 12:00,1142,1153,South,80,1358,253,Groceries,-11
02-12-2023 13:00,4682,1659,West,78,1135,719,Furniture,3023
02-12-2023 14:00,2912,2342,West,64,1983,415,Clothing,570
02-12-2023 15:00,4891,943,West,72,1432,399,Electronics,3948
02-12-2023 16:00,2092,2965,East,87,1268,539,Groceries,-873
02-12-2023 17:00,3294,1073,North,90,1532,910,Furniture,2221
02-12-2023 18:00,4332,2676,North,60,1890,250,Furniture,1656
02-12-2023 19:00,1787,1510,East,64,1648,505,Groceries,277
02-12-2023 20:00,3126,840,East,72,1685,274,Clothing,2286
02-12-2023 21:00,2681,1780,West,52,535,154,Groceries,901
02-12-2023 22:00,1622,599,South,68,1527,878,Electronics,1023
02-12-2023 23:00,4841,2586,South,50,912,410,Electronics,2255
03-12-2023 00:00,4676,2810,West,73,1610,253,Groceries,1866
03-12-2023 01:00,3572,649,West,98,982,996,Clothing,2923
03-12-2023 02:00,3819,2156,North,60,1411,599,Electronics,1663
03-12-2023 03:00,1937,1853,West,79,1102,600,Groceries,84
03-12-2023 04:00,4692,1643,South,99,1581,289,Clothing,3049
03-12-2023 05:00,4401,2107,South,60,1663,605,Clothing,2294
03-12-2023 06:00,4260,2766,East,88,671,248,Furniture,1494
03-12-2023 07:00,2118,2337,North,50,759,107,Electronics,-219
03-12-2023 08:00,1616,743,East,61,524,759,Groceries,873
03-12-2023 09:00,2031,1086,North,53,697,784,Electronics,945
03-12-2023 10:00,1066,2737,East,74,1078,692,Clothing,-1671
03-12-2023 11:00,4567,1355,North,57,922,690,Furniture,3212
03-12-2023 12:00,1190,2646,West,64,1641,568,Electronics,-1456
03-12-2023 13:00,4437,2535,South,92,1291,420,Groceries,1902
03-12-2023 14:00,3815,1329,West,79,505,671,Electronics,2486
03-12-2023 15:00,1520,1886,North,89,1620,550,Clothing,-366
03-12-2023 16:00,1989,2216,North,81,571,706,Furniture,-227
03-12-2023 17:00,2140,2187,East,93,1428,923,Electronics,-47
03-12-2023 18:00,3314,555,North,84,931,227,Clothing,2759
03-12-2023 19:00,2634,2225,West,70,1462,733,Clothing,409
03-12-2023 20:00,3532,2453,North,80,879,386,Furniture,1079
03-12-2023 21:00,4580,1545,North,85,1049,952,Clothing,3035
03-12-2023 22:00,4369,684,East,76,1307,186,Electronics,3685
03-12-2023 23:00,4980,1021,North,93,555,993,Groceries,3959
04-12-2023 00:00,2187,2101,East,57,1114,180,Furniture,86
04-12-2023 01:00,1375,2811,South,72,1626,633,Clothing,-1436
04-12-2023 02:00,1652,1748,East,72,715,351,Electronics,-96
04-12-2023 03:00,4339,2158,North,91,520,289,Furniture,2181
04-12-2023 04:00,1548,1561,South,82,709,923,Clothing,-13
04-12-2023 05:00,2097,1502,North,62,790,697,Electronics,595
04-12-2023 06:00,4579,2670,East,88,1214,583,Clothing,1909
04-12-2023 07:00,1072,2848,West,84,1334,478,Electronics,-1776
04-12-2023 08:00,3355,2517,South,65,687,555,Clothing,838
04-12-2023 09:00,1198,2428,West,61,1674,978,Furniture,-1230
04-12-2023 10:00,4201,893,West,80,690,107,Furniture,3308
04-12-2023 11:00,2781,2117,South,54,906,417,Furniture,664
04-12-2023 12:00,4895,1160,West,99,713,433,Clothing,3735
04-12-2023 13:00,1571,1928,West,89,1053,329,Clothing,-357
04-12-2023 14:00,1790,1654,West,93,1459,763,Furniture,136
04-12-2023 15:00,2638,568,West,74,1717,607,Furniture,2070
04-12-2023 16:00,2831,819,South,70,1773,889,Groceries,2012
04-12-2023 17:00,2855,2724,North,52,1092,626,Electronics,131
04-12-2023 18:00,2510,1083,West,97,540,574,Groceries,1427
04-12-2023 19:00,4924,2364,South,59,869,505,Electronics,2560
04-12-2023 20:00,2174,1683,South,72,519,386,Clothing,491
04-12-2023 21:00,4740,1081,South,66,1532,859,Electronics,3659
04-12-2023 22:00,4277,2267,South,91,1324,866,Electronics,2010
04-12-2023 23:00,1178,2056,East,84,1726,545,Clothing,-878
05-12-2023 00:00,3244,2298,North,74,517,442,Clothing,946
05-12-2023 01:00,1734,610,North,51,1247,424,Clothing,1124
05-12-2023 02:00,3136,1498,West,76,818,976,Furniture,1638
05-12-2023 03:00,1798,1257,South,95,1360,266,Furniture,541
05-12-2023 04:00,4505,782,East,58,1467,692,Electronics,3723
05-12-2023 05:00,1787,2242,South,98,1805,395,Clothing,-455
05-12-2023 06:00,3795,2741,West,53,1999,680,Furniture,1054
05-12-2023 07:00,4254,1570,North,75,751,282,Clothing,2684
05-12-2023 08:00,1208,2889,West,81,839,938,Electronics,-1681
05-12-2023 09:00,1492,1893,West,78,1250,675,Furniture,-401
05-12-2023 10:00,4201,1300,West,71,1467,875,Furniture,2901
05-12-2023 11:00,3712,630,West,96,961,938,Groceries,3082
05-12-2023 12:00,4084,1793,West,62,1130,185,Electronics,2291
05-12-2023 13:00,2657,2463,West,72,900,655,Furniture,194
05-12-2023 14:00,3918,560,West,80,870,905,Electronics,3358
05-12-2023 15:00,1731,2711,North,90,781,984,Electronics,-980
05-12-2023 16:00,2129,2048,North,85,889,248,Clothing,81
05-12-2023 17:00,4446,771,South,89,836,871,Electronics,3675
05-12-2023 18:00,2605,2281,South,80,1868,922,Groceries,324
05-12-2023 19:00,4778,2680,East,64,772,960,Furniture,2098
05-12-2023 20:00,3745,1767,East,63,1776,158,Electronics,1978
05-12-2023 21:00,4170,1957,North,84,1519,705,Electronics,2213
05-12-2023 22:00,1593,537,North,73,1139,934,Clothing,1056
05-12-2023 23:00,4658,2394,East,79,1897,104,Clothing,2264
06-12-2023 00:00,3933,1842,North,79,1317,182,Groceries,2091
06-12-2023 01:00,3899,973,East,76,505,939,Electronics,2926
06-12-2023 02:00,2215,558,South,98,1937,482,Electronics,1657
06-12-2023 03:00,1324,2463,North,89,1085,648,Electronics,-1139
06-12-2023 04:00,1978,2418,North,63,1579,578,Electronics,-440
06-12-2023 05:00,2749,1403,East,94,1921,126,Furniture,1346
06-12-2023 06:00,2850,882,West,96,1321,624,Electronics,1968
06-12-2023 07:00,4003,1911,West,60,737,676,Electronics,2092
06-12-2023 08:00,2490,584,South,96,989,513,Furniture,1906
06-12-2023 09:00,1893,2033,North,93,1545,814,Clothing,-140
06-12-2023 10:00,2390,2840,North,75,940,279,Groceries,-450
06-12-2023 11:00,4389,1590,East,70,1564,908,Electronics,2799
06-12-2023 12:00,1143,628,West,58,1357,563,Furniture,515
06-12-2023 13:00,1383,2576,West,96,757,882,Electronics,-1193
06-12-2023 14:00,3263,2068,South,50,1974,626,Clothing,1195
06-12-2023 15:00,4432,1191,West,93,547,100,Furniture,3241
06-12-2023 16:00,3371,2460,West,55,1002,370,Furniture,911
06-12-2023 17:00,4086,632,West,50,638,583,Furniture,3454
06-12-2023 18:00,1216,1708,East,71,1725,147,Electronics,-492
06-12-2023 19:00,2515,1145,West,62,1008,793,Clothing,1370
06-12-2023 20:00,3998,2112,South,87,1153,282,Groceries,1886
06-12-2023 21:00,4618,1015,West,98,1809,939,Furniture,3603
06-12-2023 22:00,3230,2545,South,94,1756,472,Electronics,685
06-12-2023 23:00,3317,2363,East,90,1839,825,Groceries,954
07-12-2023 00:00,3992,2712,East,89,960,638,Furniture,1280
07-12-2023 01:00,2490,1432,South,80,1169,606,Electronics,1058
07-12-2023 02:00,3917,2163,East,64,1844,837,Groceries,1754
07-12-2023 03:00,2635,1056,North,99,1698,769,Groceries,1579
07-12-2023 04:00,4590,2171,North,51,1562,605,Furniture,2419
07-12-2023 05:00,4613,1492,North,80,932,671,Electronics,3121
07-12-2023 06:00,3514,2128,North,75,984,165,Groceries,1386
07-12-2023 07:00,3352,2191,North,51,1581,785,Clothing,1161
07-12-2023 08:00,2167,1256,East,60,995,151,Clothing,911
07-12-2023 09:00,1110,1604,South,82,1374,569,Groceries,-494
07-12-2023 10:00,2013,1770,East,67,1100,342,Furniture,243
07-12-2023 11:00,1231,1148,West,70,1657,436,Furniture,83
07-12-2023 12:00,2714,1909,North,80,1154,902,Furniture,805
07-12-2023 13:00,4655,1491,North,75,1106,855,Groceries,3164
07-12-2023 14:00,4793,1830,East,79,655,220,Furniture,2963
07-12-2023 15:00,2755,1127,West,88,700,653,Furniture,1628
07-12-2023 16:00,4663,2554,East,70,1521,795,Clothing,2109
07-12-2023 17:00,4571,2449,South,98,998,144,Electronics,2122
07-12-2023 18:00,3642,1453,North,65,1925,151,Clothing,2189
07-12-2023 19:00,2577,2342,East,56,987,250,Groceries,235
07-12-2023 20:00,2296,2620,South,71,659,512,Clothing,-324
07-12-2023 21:00,4774,509,North,56,1734,640,Electronics,4265
07-12-2023 22:00,3220,2096,North,51,1976,668,Clothing,1124
07-12-2023 23:00,1972,621,North,86,1593,597,Furniture,1351
08-12-2023 00:00,2030,1186,West,63,1330,886,Electronics,844
08-12-2023 01:00,4226,2509,East,57,1471,308,Groceries,1717
08-12-2023 02:00,4593,940,North,78,1837,107,Clothing,3653
08-12-2023 03:00,3593,1090,North,93,930,490,Clothing,2503
08-12-2023 04:00,3595,1868,South,56,1905,346,Furniture,1727
08-12-2023 05:00,4992,2489,East,87,1690,494,Electronics,2503
08-12-2023 06:00,1517,1861,South,94,1914,806,Furniture,-344
08-12-2023 07:00,4991,1707,East,71,1842,933,Clothing,3284
08-12-2023 08:00,1913,2614,North,93,616,438,Clothing,-701
08-12-2023 09:00,3262,2564,West,66,1196,511,Electronics,698
08-12-2023 10:00,3181,1906,South,65,702,639,Clothing,1275
08-12-2023 11:00,3332,2915,West,82,1685,444,Electronics,417
08-12-2023 12:00,4197,1839,West,88,1461,942,Groceries,2358
08-12-2023 13:00,2944,2020,West,84,961,395,Clothing,924
08-12-2023 14:00,2462,2076,East,87,1443,334,Electronics,386
08-12-2023 15:00,2872,1407,East,81,1199,741,Electronics,1465
08-12-2023 16:00,3733,614,West,52,700,687,Furniture,3119
08-12-2023 17:00,4223,2647,North,52,1754,544,Clothing,1576
08-12-2023 18:00,3378,2985,North,57,1015,332,Furniture,393
08-12-2023 19:00,4609,1868,West,95,1729,841,Electronics,2741
08-12-2023 20:00,4454,2896,South,80,1854,943,Groceries,1558
08-12-2023 21:00,4186,638,South,58,1105,981,Groceries,3548
08-12-2023 22:00,3941,1327,East,54,1243,962,Clothing,2614
08-12-2023 23:00,4553,2871,South,77,1374,409,Groceries,1682
09-12-2023 00:00,2307,1345,North,64,846,800,Clothing,962
09-12-2023 01:00,1898,2841,West,98,848,577,Clothing,-943
09-12-2023 02:00,2098,2480,South,76,1683,613,Electronics,-382
09-12-2023 03:00,2189,2052,West,91,1775,435,Electronics,137
09-12-2023 04:00,2212,1815,South,80,1745,676,Electronics,397
09-12-2023 05:00,3125,573,East,89,1357,151,Furniture,2552
09-12-2023 06:00,3994,983,North,67,893,645,Electronics,3011
09-12-2023 07:00,4673,515,East,87,1919,400,Clothing,4158
09-12-2023 08:00,1687,2049,West,98,1493,851,Electronics,-362
09-12-2023 09:00,3068,1859,North,53,1477,740,Furniture,1209
09-12-2023 10:00,1565,2396,North,70,666,342,Electronics,-831
09-12-2023 11:00,2207,1650,East,96,1475,455,Groceries,557
09-12-2023 12:00,2894,628,South,91,951,919,Clothing,2266
09-12-2023 13:00,4293,1010,East,72,1661,934,Groceries,3283
09-12-2023 14:00,1826,922,West,94,1359,709,Groceries,904
09-12-2023 15:00,2351,2932,South,71,709,687,Furniture,-581
09-12-2023 16:00,3226,2406,East,50,1267,923,Groceries,820
09-12-2023 17:00,2811,731,East,74,713,541,Electronics,2080
09-12-2023 18:00,4183,1458,South,90,1883,976,Clothing,2725
09-12-2023 19:00,4807,1324,South,77,1758,830,Groceries,3483
09-12-2023 20:00,4797,564,South,86,1472,917,Groceries,4233
09-12-2023 21:00,2082,1332,East,60,1920,712,Clothing,750
09-12-2023 22:00,2350,1114,South,71,803,218,Electronics,1236
09-12-2023 23:00,3952,2528,South,74,1632,508,Groceries,1424
10-12-2023 00:00,2644,1300,South,70,1356,751,Clothing,1344
10-12-2023 01:00,4968,2467,North,85,1360,470,Electronics,2501
10-12-2023 02:00,3716,777,West,69,1307,836,Electronics,2939
10-12-2023 03:00,1190,2513,South,65,1913,866,Electronics,-1323
10-12-2023 04:00,2223,2217,West,77,619,172,Furniture,6
10-12-2023 05:00,2335,2913,South,78,1733,548,Electronics,-578
10-12-2023 06:00,1707,1738,South,99,926,923,Electronics,-31
10-12-2023 07:00,4106,2986,North,75,1444,917,Clothing,1120
10-12-2023 08:00,1378,927,North,89,829,570,Furniture,451
10-12-2023 09:00,1386,2943,South,51,1749,255,Electronics,-1557
10-12-2023 10:00,4829,2024,South,98,1134,870,Groceries,2805
10-12-2023 11:00,3284,1986,South,59,1670,675,Furniture,1298
10-12-2023 12:00,1615,1085,West,62,1863,409,Clothing,530
10-12-2023 13:00,2542,874,South,64,1063,135,Furniture,1668
10-12-2023 14:00,3330,2023,West,58,679,347,Groceries,1307
10-12-2023 15:00,3048,592,North,76,789,527,Furniture,2456
10-12-2023 16:00,2754,2100,West,57,686,143,Groceries,654
10-12-2023 17:00,1463,2868,South,55,985,552,Electronics,-1405
10-12-2023 18:00,4301,1413,North,85,1860,218,Electronics,2888
10-12-2023 19:00,1966,1845,East,99,1631,448,Furniture,121
10-12-2023 20:00,1171,2340,North,73,1649,792,Furniture,-1169
10-12-2023 21:00,4158,1801,East,52,1272,487,Clothing,2357
10-12-2023 22:00,4624,2121,West,75,1557,169,Clothing,2503
10-12-2023 23:00,2146,2061,North,85,1961,969,Groceries,85
11-12-2023 00:00,1842,2253,North,70,1799,553,Electronics,-411
11-12-2023 01:00,2321,1916,North,62,681,366,Furniture,405
11-12-2023 02:00,2908,594,West,60,1762,830,Electronics,2314
11-12-2023 03:00,1689,2279,South,57,1871,537,Furniture,-590
11-12-2023 04:00,3622,1458,West,95,645,465,Groceries,2164
11-12-2023 05:00,2507,1630,North,95,1567,801,Electronics,877
11-12-2023 06:00,3212,1913,South,97,998,867,Clothing,1299
11-12-2023 07:00,3024,2283,North,63,1302,286,Groceries,741
11-12-2023 08:00,2722,2618,North,82,1818,326,Electronics,104
11-12-2023 09:00,1382,1163,East,51,1030,160,Groceries,219
11-12-2023 10:00,3256,1468,North,50,710,267,Furniture,1788
11-12-2023 11:00,4810,2915,West,60,1392,231,Electronics,1895
11-12-2023 12:00,4503,2598,West,55,1925,254,Electronics,1905
11-12-2023 13:00,2412,1666,West,81,1754,883,Electronics,746
11-12-2023 14:00,2583,2071,South,64,1862,821,Clothing,512
11-12-2023 15:00,3271,2023,East,61,504,106,Groceries,1248
11-12-2023 16:00,3050,1487,East,86,810,622,Clothing,1563
11-12-2023 17:00,1371,2807,North,78,661,811,Clothing,-1436
11-12-2023 18:00,2710,1725,North,93,715,350,Groceries,985
11-12-2023 19:00,2469,1708,East,71,1285,675,Groceries,761
11-12-2023 20:00,1610,2705,South,95,1335,791,Electronics,-1095
11-12-2023 21:00,1115,598,West,63,1694,739,Electronics,517
11-12-2023 22:00,4341,2788,North,68,751,361,Groceries,1553
11-12-2023 23:00,1446,2014,East,54,1561,219,Electronics,-568
12-12-2023 00:00,2391,701,South,84,727,147,Furniture,1690
12-12-2023 01:00,4324,1133,West,74,1408,168,Electronics,3191
12-12-2023 02:00,2340,1245,North,99,1801,988,Groceries,1095
12-12-2023 03:00,1414,989,West,87,784,361,Clothing,425
12-12-2023 04:00,4166,1078,West,58,1148,841,Groceries,3088
12-12-2023 05:00,2808,772,East,56,865,863,Groceries,2036
12-12-2023 06:00,3939,1742,East,67,1591,544,Clothing,2197
12-12-2023 07:00,2047,1285,West,51,1627,578,Furniture,762
12-12-2023 08:00,4699,952,West,59,1924,330,Electronics,3747
12-12-2023 09:00,3710,1675,North,93,1769,323,Furniture,2035
12-12-2023 10:00,2873,2894,South,51,691,556,Clothing,-21
12-12-2023 11:00,2073,1315,South,94,1143,818,Furniture,758
12-12-2023 12:00,4573,913,West,57,1819,952,Clothing,3660
12-12-2023 13:00,1717,2050,East,56,1667,465,Groceries,-333
12-12-2023 14:00,4569,930,South,84,1406,127,Furniture,3639
12-12-2023 15:00,2358,2926,West,72,1230,976,Electronics,-568
12-12-2023 16:00,4150,1394,East,57,525,830,Electronics,2756
12-12-2023 17:00,2605,2975,North,70,1774,948,Clothing,-370
12-12-2023 18:00,4098,2446,South,82,1211,200,Groceries,1652
12-12-2023 19:00,3318,1607,North,96,1114,157,Furniture,1711
12-12-2023 20:00,1561,691,East,50,692,123,Furniture,870
12-12-2023 21:00,3851,540,West,61,880,514,Clothing,3311
12-12-2023 22:00,3294,2387,North,60,1525,326,Furniture,907
12-12-2023 23:00,4847,2359,West,97,1568,268,Electronics,2488
13-12-2023 00:00,4662,2296,South,79,1438,588,Electronics,2366
13-12-2023 01:00,1386,1832,North,53,502,345,Furniture,-446
13-12-2023 02:00,1701,635,South,83,1429,935,Furniture,1066
13-12-2023 03:00,3606,2313,South,72,1972,823,Groceries,1293
13-12-2023 04:00,1972,605,South,81,1658,462,Groceries,1367
13-12-2023 05:00,2384,1018,South,52,1814,564,Furniture,1366
13-12-2023 06:00,4937,2441,South,77,777,529,Furniture,2496
13-12-2023 07:00,1983,2065,East,53,675,877,Clothing,-82
13-12-2023 08:00,2511,625,North,99,781,520,Groceries,1886
13-12-2023 09:00,1351,2947,West,61,1643,120,Furniture,-1596
13-12-2023 10:00,2724,2626,West,73,1697,735,Clothing,98
13-12-2023 11:00,2951,888,East,82,1962,468,Groceries,2063
13-12-2023 12:00,2279,2058,West,52,958,563,Clothing,221
13-12-2023 13:00,4293,2224,West,53,1450,196,Furniture,2069
13-12-2023 14:00,2907,2621,West,79,840,749,Electronics,286
13-12-2023 15:00,1752,1528,North,55,1196,591,Electronics,224
13-12-2023 16:00,3828,2442,West,98,1225,949,Electronics,1386
13-12-2023 17:00,2024,581,North,79,620,452,Electronics,1443
13-12-2023 18:00,1545,2060,West,57,1074,704,Furniture,-515
13-12-2023 19:00,2469,1275,West,67,775,194,Electronics,1194
13-12-2023 20:00,1078,777,North,65,1468,123,Electronics,301
13-12-2023 21:00,2259,2378,East,55,1486,479,Furniture,-119
13-12-2023 22:00,3381,2771,West,73,528,495,Groceries,610
13-12-2023 23:00,1888,2107,South,77,1184,503,Groceries,-219
14-12-2023 00:00,4420,1105,South,81,1767,747,Groceries,3315
14-12-2023 01:00,4169,2566,East,74,820,945,Clothing,1603
14-12-2023 02:00,2105,1139,South,77,1142,232,Groceries,966
14-12-2023 03:00,3549,2289,North,70,851,153,Furniture,1260
14-12-2023 04:00,2990,2256,West,57,1031,391,Groceries,734
14-12-2023 05:00,2500,1866,West,85,1604,211,Clothing,634
14-12-2023 06:00,4998,2644,West,58,1816,521,Clothing,2354
14-12-2023 07:00,4775,674,West,89,793,230,Electronics,4101
14-12-2023 08:00,3812,1876,South,70,957,519,Furniture,1936
14-12-2023 09:00,1920,847,South,50,1246,377,Groceries,1073
14-12-2023 10:00,1549,500,South,53,1232,875,Groceries,1049
14-12-2023 11:00,3061,562,North,59,1583,993,Furniture,2499
14-12-2023 12:00,1391,2283,South,75,1042,689,Furniture,-892
14-12-2023 13:00,4418,725,South,89,879,874,Furniture,3693
14-12-2023 14:00,3357,2970,West,52,823,167,Furniture,387
14-12-2023 15:00,3433,1542,South,93,1585,673,Furniture,1891
14-12-2023 16:00,4280,2578,East,58,1444,502,Furniture,1702
14-12-2023 17:00,2380,1344,East,81,1669,974,Furniture,1036
14-12-2023 18:00,1973,523,West,52,1342,274,Clothing,1450
14-12-2023 19:00,4672,1734,South,53,861,379,Electronics,2938
14-12-2023 20:00,4639,2484,East,55,552,563,Groceries,2155
14-12-2023 21:00,4165,660,East,58,901,489,Clothing,3505
14-12-2023 22:00,4164,1778,North,75,1180,847,Clothing,2386
14-12-2023 23:00,1339,2094,West,51,1492,235,Groceries,-755
15-12-2023 00:00,3644,2661,East,51,1368,508,Clothing,983
15-12-2023 01:00,4516,2452,East,99,1206,323,Furniture,2064
15-12-2023 02:00,1756,2195,West,70,1972,700,Clothing,-439
15-12-2023 03:00,2045,1454,South,71,1606,718,Groceries,591
15-12-2023 04:00,3338,856,West,52,878,652,Electronics,2482
15-12-2023 05:00,4556,2716,North,84,1145,797,Groceries,1840
15-12-2023 06:00,4855,1468,North,99,1981,287,Electronics,3387
15-12-2023 07:00,3353,741,North,87,1432,977,Furniture,2612
15-12-2023 08:00,3681,638,East,82,580,486,Clothing,3043
15-12-2023 09:00,4199,2644,South,64,1230,108,Groceries,1555
15-12-2023 10:00,3672,646,North,60,1013,279,Groceries,3026
15-12-2023 11:00,1938,1580,West,59,1832,797,Electronics,358
15-12-2023 12:00,4344,1565,North,85,1420,543,Clothing,2779
15-12-2023 13:00,1847,1042,East,63,1262,693,Groceries,805
15-12-2023 14:00,1441,1191,North,51,993,788,Groceries,250
15-12-2023 15:00,3550,1525,South,94,1759,705,Clothing,2025
15-12-2023 16:00,1129,1661,North,97,1440,545,Furniture,-532
15-12-2023 17:00,4203,2140,South,93,1560,215,Electronics,2063
15-12-2023 18:00,1596,1229,South,86,1240,771,Groceries,367
15-12-2023 19:00,2958,2878,West,78,824,344,Clothing,80
15-12-2023 20:00,2505,903,South,84,1579,382,Furniture,1602
15-12-2023 21:00,1861,2439,East,69,1644,312,Groceries,-578
15-12-2023 22:00,4461,1650,East,70,813,763,Furniture,2811
15-12-2023 23:00,3640,2235,South,83,1734,777,Groceries,1405
16-12-2023 00:00,1998,1538,South,98,602,550,Groceries,460
16-12-2023 01:00,3372,2773,North,92,938,754,Furniture,599
16-12-2023 02:00,4140,1244,North,82,1316,124,Electronics,2896
16-12-2023 03:00,4731,818,West,68,1246,811,Furniture,3913
16-12-2023 04:00,3495,1742,North,57,537,332,Clothing,1753
16-12-2023 05:00,2551,1272,East,80,1312,615,Groceries,1279
16-12-2023 06:00,3866,2416,North,60,1937,387,Furniture,1450
16-12-2023 07:00,2640,2999,West,57,1747,784,Furniture,-359
16-12-2023 08:00,4236,1443,West,74,1516,283,Groceries,2793
16-12-2023 09:00,2511,2514,South,98,1816,350,Groceries,-3
16-12-2023 10:00,2736,1713,West,69,654,390,Furniture,1023
16-12-2023 11:00,3756,918,South,87,1555,897,Electronics,2838
16-12-2023 12:00,2449,1364,East,56,1757,458,Groceries,1085
16-12-2023 13:00,4768,1288,East,62,988,723,Furniture,3480
16-12-2023 14:00,2857,2371,North,88,1856,404,Clothing,486
16-12-2023 15:00,1264,994,West,92,1540,449,Electronics,270
16-12-2023 16:00,4946,1562,East,59,1937,438,Clothing,3384
16-12-2023 17:00,3659,2709,South,57,739,578,Groceries,950
16-12-2023 18:00,4413,2525,West,91,1809,564,Groceries,1888
16-12-2023 19:00,3879,2668,West,92,845,229,Electronics,1211
16-12-2023 20:00,4797,2946,South,69,1898,286,Groceries,1851
16-12-2023 21:00,4349,2485,West,66,515,520,Clothing,1864
16-12-2023 22:00,3721,1227,West,60,1086,595,Furniture,2494
16-12-2023 23:00,2462,1060,East,65,1449,640,Furniture,1402
17-12-2023 00:00,1156,1652,South,86,759,769,Clothing,-496
17-12-2023 01:00,2445,1039,East,91,860,985,Clothing,1406
17-12-2023 02:00,3298,2903,South,81,1922,334,Groceries,395
17-12-2023 03:00,3925,1159,North,75,959,377,Groceries,2766
17-12-2023 04:00,2632,2979,West,86,1430,201,Electronics,-347
17-12-2023 05:00,3577,2363,West,58,1608,558,Furniture,1214
17-12-2023 06:00,3374,1950,East,84,1586,836,Electronics,1424
17-12-2023 07:00,4008,1316,West,52,599,886,Clothing,2692
17-12-2023 08:00,1894,2444,West,80,1254,934,Clothing,-550
17-12-2023 09:00,3144,1715,East,91,794,331,Electronics,1429
17-12-2023 10:00,1512,511,East,56,1685,953,Electronics,1001
17-12-2023 11:00,1215,2786,South,51,1428,373,Furniture,-1571
17-12-2023 12:00,4203,2395,North,74,1701,464,Clothing,1808
17-12-2023 13:00,4331,2930,East,89,1967,577,Electronics,1401
17-12-2023 14:00,3172,547,South,61,827,567,Furniture,2625
17-12-2023 15:00,4153,2864,East,79,1851,724,Groceries,1289
17-12-2023 16:00,4354,2756,South,79,1263,750,Groceries,1598
17-12-2023 17:00,2706,2070,North,78,1565,827,Furniture,636
17-12-2023 18:00,3106,1076,South,90,741,925,Electronics,2030
17-12-2023 19:00,2567,2862,South,60,1865,373,Furniture,-295
17-12-2023 20:00,3208,1253,West,72,1614,427,Furniture,1955
17-12-2023 21:00,3331,1559,East,66,1551,960,Electronics,1772
17-12-2023 22:00,3153,1053,South,62,958,283,Groceries,2100
17-12-2023 23:00,2128,902,East,82,1166,923,Furniture,1226
18-12-2023 00:00,4510,1630,South,50,1908,293,Groceries,2880
18-12-2023 01:00,1227,2586,West,89,719,890,Furniture,-1359
18-12-2023 02:00,4771,2727,West,62,1358,371,Clothing,2044
18-12-2023 03:00,4653,2559,North,87,763,399,Electronics,2094
18-12-2023 04:00,3365,1047,South,52,620,683,Groceries,2318
18-12-2023 05:00,2487,1649,West,65,1569,295,Electronics,838
18-12-2023 06:00,1801,562,East,91,1803,881,Groceries,1239
18-12-2023 07:00,2622,1343,South,56,1638,430,Groceries,1279
18-12-2023 08:00,2905,1508,South,52,1691,851,Electronics,1397
18-12-2023 09:00,3921,2342,North,63,934,585,Furniture,1579
18-12-2023 10:00,1471,2531,East,65,1769,719,Furniture,-1060
18-12-2023 11:00,2079,1822,North,53,983,598,Clothing,257
18-12-2023 12:00,3672,2581,South,80,1898,499,Groceries,1091
18-12-2023 13:00,3060,1251,North,62,779,496,Electronics,1809
18-12-2023 14:00,4511,548,South,76,1545,903,Groceries,3963
18-12-2023 15:00,2041,1157,South,50,1213,911,Furniture,884
18-12-2023 16:00,3741,2160,North,74,567,199,Electronics,1581
18-12-2023 17:00,4020,1200,North,86,1242,180,Electronics,2820
18-12-2023 18:00,3160,1580,South,99,1581,881,Groceries,1580
18-12-2023 19:00,1228,2656,North,93,1787,960,Clothing,-1428
18-12-2023 20:00,1170,2040,North,60,1946,116,Furniture,-870
18-12-2023 21:00,1294,2571,South,58,1521,804,Furniture,-1277
18-12-2023 22:00,1188,2768,East,56,790,311,Groceries,-1580
18-12-2023 23:00,1425,2483,North,63,668,964,Groceries,-1058
19-12-2023 00:00,1976,814,North,79,1985,225,Clothing,1162
19-12-2023 01:00,2102,2841,West,73,1055,921,Furniture,-739
19-12-2023 02:00,3705,2200,East,52,852,737,Clothing,1505
19-12-2023 03:00,1918,1517,North,97,1763,229,Electronics,401
19-12-2023 04:00,4253,1137,South,88,782,756,Electronics,3116
19-12-2023 05:00,1498,2814,West,76,1972,867,Clothing,-1316
19-12-2023 06:00,2821,2635,West,50,1589,634,Clothing,186
19-12-2023 07:00,3809,2149,West,87,1850,313,Groceries,1660
19-12-2023 08:00,1865,2978,North,75,955,228,Furniture,-1113
19-12-2023 09:00,1825,2275,South,55,1458,623,Furniture,-450
19-12-2023 10:00,4779,2466,West,91,1504,752,Furniture,2313
19-12-2023 11:00,2858,2463,East,61,976,561,Clothing,395
19-12-2023 12:00,3118,2267,West,87,784,879,Groceries,851
19-12-2023 13:00,3295,741,West,95,530,156,Groceries,2554
19-12-2023 14:00,1145,1201,East,84,947,697,Groceries,-56
19-12-2023 15:00,2641,1240,West,59,713,373,Clothing,1401
19-12-2023 16:00,4846,2613,West,58,1548,714,Clothing,2233
19-12-2023 17:00,2319,2925,East,72,1896,438,Groceries,-606
19-12-2023 18:00,3629,2935,North,79,896,961,Clothing,694
19-12-2023 19:00,1469,2314,East,71,836,242,Electronics,-845
19-12-2023 20:00,4577,1280,North,96,1435,522,Furniture,3297
19-12-2023 21:00,1192,2756,North,58,1467,433,Furniture,-1564
19-12-2023 22:00,2091,515,North,68,1354,940,Furniture,1576
19-12-2023 23:00,3541,1485,East,57,1402,787,Electronics,2056
20-12-2023 00:00,4888,866,East,53,1171,232,Groceries,4022
20-12-2023 01:00,1051,1752,North,54,1803,955,Furniture,-701
20-12-2023 02:00,3929,2987,East,68,1268,363,Clothing,942
20-12-2023 03:00,3410,1189,North,95,1122,246,Electronics,2221
20-12-2023 04:00,2820,1559,East,67,1058,535,Groceries,1261
20-12-2023 05:00,3964,1346,South,78,1047,111,Electronics,2618
20-12-2023 06:00,3521,921,East,68,1422,939,Furniture,2600
20-12-2023 07:00,2869,2143,East,55,1721,154,Groceries,726
20-12-2023 08:00,3568,1712,East,54,1053,329,Furniture,1856
20-12-2023 09:00,2786,1107,North,92,978,221,Groceries,1679
20-12-2023 10:00,2454,1838,North,54,1343,960,Furniture,616
20-12-2023 11:00,2867,519,South,57,569,332,Groceries,2348
20-12-2023 12:00,4369,1175,South,76,1004,261,Electronics,3194
20-12-2023 13:00,4506,881,West,86,609,693,Groceries,3625
20-12-2023 14:00,4767,1108,South,92,1905,658,Groceries,3659
20-12-2023 15:00,3738,2690,North,94,896,975,Electronics,1048
20-12-2023 16:00,4269,561,South,87,1932,902,Groceries,3708
20-12-2023 17:00,4199,1765,South,86,850,599,Electronics,2434
20-12-2023 18:00,3579,2785,East,67,1494,771,Furniture,794
20-12-2023 19:00,3007,1654,South,75,1288,278,Furniture,1353
20-12-2023 20:00,2434,2128,West,91,920,461,Furniture,306
20-12-2023 21:00,1839,2126,East,65,1421,307,Groceries,-287
20-12-2023 22:00,4136,1646,North,71,610,651,Clothing,2490
20-12-2023 23:00,4765,1963,West,95,708,825,Clothing,2802
21-12-2023 00:00,1240,1426,North,72,1962,531,Furniture,-186
21-12-2023 01:00,4440,2889,West,96,1701,555,Electronics,1551
21-12-2023 02:00,1535,1942,East,52,1430,603,Groceries,-407
21-12-2023 03:00,2407,2153,West,52,924,963,Electronics,254
21-12-2023 04:00,4502,781,West,61,827,253,Groceries,3721
21-12-2023 05:00,1082,1385,South,72,510,437,Electronics,-303
21-12-2023 06:00,1981,1524,North,96,1775,392,Furniture,457
21-12-2023 07:00,4902,1222,East,60,1355,535,Clothing,3680
21-12-2023 08:00,4768,2298,West,91,1758,495,Electronics,2470
21-12-2023 09:00,1950,1735,North,96,753,265,Furniture,215
21-12-2023 10:00,4899,586,North,99,628,551,Clothing,4313
21-12-2023 11:00,1610,1164,South,95,599,883,Clothing,446
21-12-2023 12:00,1573,1361,North,78,789,635,Clothing,212
21-12-2023 13:00,3333,2222,East,55,1749,500,Electronics,1111
21-12-2023 14:00,1988,2608,South,95,1648,214,Electronics,-620
21-12-2023 15:00,4605,2642,West,65,1961,450,Clothing,1963
21-12-2023 16:00,1458,1285,East,83,1145,359,Electronics,173
21-12-2023 17:00,4283,2076,East,86,1164,917,Furniture,2207
21-12-2023 18:00,3173,2167,East,60,1870,975,Groceries,1006
21-12-2023 19:00,4484,2844,South,60,1197,325,Clothing,1640
21-12-2023 20:00,2522,1193,North,74,682,713,Groceries,1329
21-12-2023 21:00,3472,2946,East,68,850,585,Clothing,526
21-12-2023 22:00,3601,1754,North,81,1901,230,Groceries,1847
21-12-2023 23:00,3657,1033,North,99,1207,363,Clothing,2624
22-12-2023 00:00,2984,901,East,57,1988,623,Furniture,2083
22-12-2023 01:00,2566,629,North,61,1177,933,Clothing,1937
22-12-2023 02:00,4229,2839,South,90,1301,280,Furniture,1390
22-12-2023 03:00,3159,775,South,84,839,448,Clothing,2384
22-12-2023 04:00,3449,2358,West,55,1664,570,Electronics,1091
22-12-2023 05:00,4830,554,North,70,610,260,Groceries,4276
22-12-2023 06:00,1121,1264,North,75,760,213,Furniture,-143
22-12-2023 07:00,1272,1720,West,50,1711,117,Clothing,-448
22-12-2023 08:00,2317,1141,South,66,870,203,Electronics,1176
22-12-2023 09:00,1397,2347,West,84,1881,285,Clothing,-950
22-12-2023 10:00,3518,1223,West,76,1796,441,Groceries,2295
22-12-2023 11:00,1984,1713,West,99,1103,561,Clothing,271
22-12-2023 12:00,2230,1301,North,99,948,704,Electronics,929
22-12-2023 13:00,2133,1237,North,51,1940,912,Clothing,896
22-12-2023 14:00,4511,1257,North,85,1360,242,Clothing,3254
22-12-2023 15:00,2301,2091,North,50,1911,754,Furniture,210
22-12-2023 16:00,4639,1799,East,59,1861,912,Furniture,2840
22-12-2023 17:00,2910,2341,West,80,1834,711,Clothing,569
22-12-2023 18:00,4986,839,West,86,1852,552,Clothing,4147
22-12-2023 19:00,3616,652,North,54,1570,550,Electronics,2964
22-12-2023 20:00,2505,2088,South,90,1155,161,Clothing,417
22-12-2023 21:00,4874,1921,East,95,648,695,Groceries,2953
22-12-2023 22:00,4185,1967,East,62,849,375,Furniture,2218
22-12-2023 23:00,2916,926,South,94,822,778,Groceries,1990
23-12-2023 00:00,3944,2751,North,73,1364,394,Clothing,1193
23-12-2023 01:00,1819,1635,East,76,1643,228,Electronics,184
23-12-2023 02:00,3900,2872,East,50,1504,463,Groceries,1028
23-12-2023 03:00,4548,1449,West,98,897,166,Clothing,3099
23-12-2023 04:00,3757,1873,West,69,1145,146,Furniture,1884
23-12-2023 05:00,2956,2530,North,57,1720,473,Clothing,426
23-12-2023 06:00,3368,1456,North,52,912,921,Furniture,1912
23-12-2023 07:00,1178,2201,West,98,1962,759,Electronics,-1023
23-12-2023 08:00,1896,2982,West,81,536,861,Furniture,-1086
23-12-2023 09:00,3266,1803,West,93,686,236,Clothing,1463
23-12-2023 10:00,3836,870,South,74,919,194,Electronics,2966
23-12-2023 11:00,2972,2796,East,74,1224,337,Furniture,176
23-12-2023 12:00,2551,2728,North,99,1983,895,Furniture,-177
23-12-2023 13:00,1491,1202,North,63,1633,931,Groceries,289
23-12-2023 14:00,4962,2174,South,92,686,134,Furniture,2788
23-12-2023 15:00,1060,2625,West,76,970,395,Clothing,-1565
23-12-2023 16:00,2077,2883,East,97,1601,992,Electronics,-806
23-12-2023 17:00,2703,549,West,81,1897,969,Clothing,2154
23-12-2023 18:00,3585,2632,North,76,1309,591,Furniture,953
23-12-2023 19:00,3895,2551,South,53,829,357,Clothing,1344
23-12-2023 20:00,4035,1492,East,99,1648,486,Groceries,2543
23-12-2023 21:00,1064,2864,East,88,1839,369,Clothing,-1800
23-12-2023 22:00,4683,1634,East,60,1457,966,Electronics,3049
23-12-2023 23:00,1585,1857,East,97,819,423,Electronics,-272
24-12-2023 00:00,2727,2374,South,97,974,146,Furniture,353
24-12-2023 01:00,3218,1262,North,52,1325,705,Electronics,1956
24-12-2023 02:00,4344,1504,East,74,1013,793,Clothing,2840
24-12-2023 03:00,4960,2666,East,73,833,801,Furniture,2294
24-12-2023 04:00,4770,849,North,58,1594,586,Clothing,3921
24-12-2023 05:00,1534,1186,West,57,964,662,Groceries,348
24-12-2023 06:00,4462,1041,East,88,1899,817,Clothing,3421
24-12-2023 07:00,3740,860,East,80,1223,915,Electronics,2880
24-12-2023 08:00,4398,2877,West,66,507,510,Electronics,1521
24-12-2023 09:00,3155,2766,North,92,663,944,Groceries,389
24-12-2023 10:00,2870,2755,North,80,1280,224,Furniture,115
24-12-2023 11:00,4233,2193,East,53,1818,311,Electronics,2040
24-12-2023 12:00,3861,584,North,53,857,468,Electronics,3277
24-12-2023 13:00,2004,1184,West,86,580,365,Electronics,820
24-12-2023 14:00,3499,744,South,57,1273,234,Groceries,2755
24-12-2023 15:00,2229,1858,West,91,1798,983,Groceries,371
24-12-2023 16:00,3637,1095,West,98,1420,884,Electronics,2542
24-12-2023 17:00,2039,1656,South,55,1398,889,Furniture,383
24-12-2023 18:00,1326,2323,West,58,1421,414,Electronics,-997
24-12-2023 19:00,1607,2297,East,91,1570,399,Clothing,-690
24-12-2023 20:00,3706,849,East,57,1915,878,Clothing,2857
24-12-2023 21:00,1001,2829,North,81,1324,397,Furniture,-1828
24-12-2023 22:00,2033,2840,North,64,1517,378,Electronics,-807
24-12-2023 23:00,3481,1792,West,67,1602,473,Furniture,1689
25-12-2023 00:00,1124,2384,East,72,1179,825,Clothing,-1260
25-12-2023 01:00,2104,2060,East,54,1546,587,Electronics,44
25-12-2023 02:00,3532,1483,South,99,1751,161,Electronics,2049
25-12-2023 03:00,3699,2567,North,76,937,978,Clothing,1132
25-12-2023 04:00,2861,2363,East,82,1821,153,Furniture,498
25-12-2023 05:00,2173,2479,West,51,1445,437,Furniture,-306
25-12-2023 06:00,3847,2236,East,91,1783,474,Groceries,1611
25-12-2023 07:00,3920,2952,North,87,1275,976,Groceries,968
25-12-2023 08:00,4411,1638,West,77,1175,573,Groceries,2773
25-12-2023 09:00,1128,2418,North,73,509,211,Furniture,-1290
25-12-2023 10:00,1437,1200,East,70,657,368,Electronics,237
25-12-2023 11:00,1750,2573,East,80,1367,423,Electronics,-823
25-12-2023 12:00,3548,1065,East,60,1283,718,Groceries,2483
25-12-2023 13:00,4129,894,North,99,1681,894,Furniture,3235
25-12-2023 14:00,2221,2456,West,77,819,982,Groceries,-235
25-12-2023 15:00,3258,1022,East,97,1725,779,Furniture,2236
25-12-2023 16:00,4985,2062,East,89,620,685,Furniture,2923
25-12-2023 17:00,1901,1606,East,53,638,847,Groceries,295
25-12-2023 18:00,3092,1049,South,92,1173,703,Electronics,2043
25-12-2023 19:00,4168,1968,South,91,1862,184,Electronics,2200
25-12-2023 20:00,2302,2634,West,65,1783,471,Furniture,-332
25-12-2023 21:00,3582,1332,North,61,1956,174,Clothing,2250
25-12-2023 22:00,2433,886,East,71,543,695,Clothing,1547
25-12-2023 23:00,3508,1462,East,84,1682,856,Clothing,2046
26-12-2023 00:00,1390,1921,North,92,1315,607,Groceries,-531
26-12-2023 01:00,4918,785,North,65,1878,327,Electronics,4133
26-12-2023 02:00,2067,868,West,73,597,694,Clothing,1199
26-12-2023 03:00,1026,1945,North,84,738,493,Clothing,-919
26-12-2023 04:00,3841,2241,East,77,974,114,Clothing,1600
26-12-2023 05:00,4168,1966,West,91,1023,912,Clothing,2202
26-12-2023 06:00,4022,2276,South,78,1056,280,Groceries,1746
26-12-2023 07:00,1547,2043,West,70,1915,607,Electronics,-496
26-12-2023 08:00,3668,1414,West,97,508,437,Electronics,2254
26-12-2023 09:00,1566,787,West,74,1912,362,Electronics,779
26-12-2023 10:00,1703,594,North,88,1733,177,Clothing,1109
26-12-2023 11:00,2242,2588,East,80,1577,328,Furniture,-346
26-12-2023 12:00,1184,830,North,64,1115,844,Groceries,354
26-12-2023 13:00,4140,2336,East,96,651,129,Groceries,1804
26-12-2023 14:00,4900,2304,North,91,909,473,Groceries,2596
26-12-2023 15:00,4201,1678,West,84,509,254,Electronics,2523
26-12-2023 16:00,2590,774,East,87,1456,916,Electronics,1816
26-12-2023 17:00,2913,2088,North,99,1051,284,Groceries,825
26-12-2023 18:00,4680,2726,West,71,1055,547,Clothing,1954
26-12-2023 19:00,1847,2456,South,54,1379,968,Furniture,-609
26-12-2023 20:00,1598,2275,North,97,767,546,Electronics,-677
26-12-2023 21:00,1805,2684,North,62,1513,531,Electronics,-879
26-12-2023 22:00,4702,1266,South,81,1166,866,Clothing,3436
26-12-2023 23:00,4791,1487,North,52,950,268,Clothing,3304
27-12-2023 00:00,2357,2259,South,64,1093,180,Electronics,98
27-12-2023 01:00,4996,1703,East,76,1720,897,Clothing,3293
27-12-2023 02:00,4225,2790,South,76,897,309,Clothing,1435
27-12-2023 03:00,4618,1619,West,79,1420,358,Clothing,2999
27-12-2023 04:00,3126,696,South,55,1575,648,Furniture,2430
27-12-2023 05:00,3626,1025,East,74,1992,385,Furniture,2601
27-12-2023 06:00,2878,1131,South,77,1891,153,Furniture,1747
27-12-2023 07:00,3460,1910,South,71,1897,568,Clothing,1550
27-12-2023 08:00,1545,907,East,53,1582,468,Clothing,638
27-12-2023 09:00,2632,1792,North,64,793,823,Furniture,840
27-12-2023 10:00,3216,1694,North,75,1287,953,Furniture,1522
27-12-2023 11:00,3728,2448,West,67,1451,199,Groceries,1280
27-12-2023 12:00,4734,1190,West,58,1368,696,Electronics,3544
27-12-2023 13:00,3630,2717,South,53,609,824,Furniture,913
27-12-2023 14:00,3562,658,North,97,606,875,Groceries,2904
27-12-2023 15:00,4385,2994,North,99,1512,697,Groceries,1391
27-12-2023 16:00,3079,2189,South,54,796,674,Furniture,890
27-12-2023 17:00,3334,2437,East,94,1338,546,Groceries,897
27-12-2023 18:00,3641,1517,North,55,1618,291,Furniture,2124
27-12-2023 19:00,4114,1580,West,61,1484,513,Electronics,2534
27-12-2023 20:00,2926,611,South,80,1344,581,Electronics,2315
27-12-2023 21:00,1616,547,East,96,1995,192,Electronics,1069
27-12-2023 22:00,4072,2410,West,58,578,352,Furniture,1662
27-12-2023 23:00,4644,875,North,56,1773,749,Groceries,3769
28-12-2023 00:00,3317,1327,East,78,1229,660,Furniture,1990
28-12-2023 01:00,2203,2580,West,63,838,732,Electronics,-377
28-12-2023 02:00,2759,1126,South,69,556,138,Groceries,1633
28-12-2023 03:00,3565,2419,East,97,1419,645,Clothing,1146
28-12-2023 04:00,4174,1526,East,81,646,457,Electronics,2648
28-12-2023 05:00,4081,2391,South,71,1245,877,Furniture,1690
28-12-2023 06:00,3630,2589,North,85,1540,108,Furniture,1041
28-12-2023 07:00,4161,2556,North,93,867,287,Furniture,1605
28-12-2023 08:00,1225,1318,East,67,1208,707,Clothing,-93
28-12-2023 09:00,1669,1156,East,89,1712,744,Groceries,513
28-12-2023 10:00,2763,2311,East,98,747,774,Furniture,452
28-12-2023 11:00,1916,1289,West,74,649,238,Furniture,627
28-12-2023 12:00,3173,1959,East,80,1213,397,Furniture,1214
28-12-2023 13:00,4003,1654,North,84,1736,179,Electronics,2349
28-12-2023 14:00,4280,2129,South,75,716,702,Electronics,2151
28-12-2023 15:00,4168,2043,South,53,1529,355,Clothing,2125
28-12-2023 16:00,3121,2173,South,91,1169,759,Groceries,948
28-12-2023 17:00,4698,2404,East,97,1360,278,Groceries,2294
28-12-2023 18:00,2214,1936,East,69,1918,356,Furniture,278
28-12-2023 19:00,2705,1435,South,83,803,317,Furniture,1270
28-12-2023 20:00,2842,520,West,61,1934,366,Electronics,2322
28-12-2023 21:00,2983,1498,West,65,902,416,Electronics,1485
28-12-2023 22:00,4787,1931,West,91,1359,690,Electronics,2856
28-12-2023 23:00,1055,956,West,54,879,778,Electronics,99
29-12-2023 00:00,1719,1967,North,93,951,715,Furniture,-248
29-12-2023 01:00,3600,2527,South,84,1752,915,Electronics,1073
29-12-2023 02:00,3079,764,North,93,1193,949,Groceries,2315
29-12-2023 03:00,4598,2731,East,76,644,383,Electronics,1867
29-12-2023 04:00,1573,2774,West,50,549,444,Clothing,-1201
29-12-2023 05:00,1666,2546,West,83,1947,826,Electronics,-880
29-12-2023 06:00,1283,1468,South,92,1623,174,Furniture,-185
29-12-2023 07:00,2744,1304,West,81,842,836,Furniture,1440
29-12-2023 08:00,4903,1753,South,93,1381,435,Furniture,3150
29-12-2023 09:00,4565,1222,East,88,1389,903,Electronics,3343
29-12-2023 10:00,3234,1595,West,82,1536,954,Groceries,1639
29-12-2023 11:00,1497,1501,West,80,1261,681,Furniture,-4
29-12-2023 12:00,2465,583,North,62,1347,462,Groceries,1882
29-12-2023 13:00,1129,1239,South,94,1423,289,Furniture,-110
29-12-2023 14:00,1638,2257,South,51,1695,571,Furniture,-619
29-12-2023 15:00,4363,2493,West,79,1882,205,Groceries,1870
29-12-2023 16:00,3161,722,North,59,1629,169,Clothing,2439
29-12-2023 17:00,4270,2952,West,72,688,621,Furniture,1318
29-12-2023 18:00,3060,1692,South,82,1573,313,Groceries,1368
29-12-2023 19:00,4342,828,South,88,1772,616,Furniture,3514
29-12-2023 20:00,4672,925,West,94,909,127,Electronics,3747
29-12-2023 21:00,4286,2077,East,78,1914,414,Groceries,2209
29-12-2023 22:00,3491,1269,West,79,1902,852,Furniture,2222
29-12-2023 23:00,4861,1719,North,83,726,606,Clothing,3142
30-12-2023 00:00,4583,1107,South,88,712,335,Electronics,3476
30-12-2023 01:00,3494,2352,South,66,1504,191,Furniture,1142
30-12-2023 02:00,1985,2624,West,71,1869,929,Electronics,-639
30-12-2023 03:00,1992,2546,East,54,918,956,Clothing,-554
30-12-2023 04:00,3762,1800,South,60,1607,462,Groceries,1962
30-12-2023 05:00,3121,1419,West,71,1418,137,Furniture,1702
30-12-2023 06:00,3584,965,East,81,1720,830,Groceries,2619
30-12-2023 07:00,1100,2464,West,73,1276,763,Furniture,-1364
30-12-2023 08:00,3223,1971,West,60,720,803,Furniture,1252
30-12-2023 09:00,1426,2445,West,60,675,732,Groceries,-1019
30-12-2023 10:00,4188,1683,South,66,1083,590,Groceries,2505
30-12-2023 11:00,4237,2860,East,81,1845,782,Furniture,1377
30-12-2023 12:00,1040,2154,North,68,1034,209,Clothing,-1114
30-12-2023 13:00,1428,2539,North,76,1224,243,Clothing,-1111
30-12-2023 14:00,1343,1684,South,81,1917,677,Furniture,-341
30-12-2023 15:00,4495,2855,South,74,823,933,Groceries,1640
30-12-2023 16:00,1365,2198,West,77,584,296,Clothing,-833
30-12-2023 17:00,4191,2636,West,89,1519,145,Furniture,1555
30-12-2023 18:00,1608,1277,East,76,1386,248,Electronics,331
30-12-2023 19:00,3704,2918,West,63,1950,671,Furniture,786
30-12-2023 20:00,1727,2998,East,91,1791,237,Groceries,-1271
30-12-2023 21:00,3276,666,West,88,611,589,Furniture,2610
30-12-2023 22:00,1824,2939,West,51,1127,501,Electronics,-1115
30-12-2023 23:00,4201,1235,North,66,1448,701,Electronics,2966
31-12-2023 00:00,2375,1424,South,50,1249,823,Furniture,951
31-12-2023 01:00,1888,1673,East,94,1921,780,Electronics,215
31-12-2023 02:00,3043,1991,North,81,551,724,Furniture,1052
31-12-2023 03:00,2341,2489,West,68,583,440,Groceries,-148
31-12-2023 04:00,4031,1566,North,63,1211,677,Groceries,2465
31-12-2023 05:00,4720,1444,East,80,1230,401,Groceries,3276
31-12-2023 06:00,3883,528,South,67,1240,217,Clothing,3355
31-12-2023 07:00,4408,2397,North,63,1328,836,Furniture,2011
31-12-2023 08:00,2296,2155,East,96,924,250,Groceries,141
31-12-2023 09:00,1116,2372,West,63,1544,266,Furniture,-1256
31-12-2023 10:00,3865,1554,North,73,555,706,Electronics,2311
31-12-2023 11:00,3415,2197,South,54,1814,871,Groceries,1218
31-12-2023 12:00,2117,2675,East,65,1311,524,Clothing,-558
31-12-2023 13:00,1167,2988,South,54,1306,870,Groceries,-1821
31-12-2023 14:00,4001,1911,West,62,1508,536,Clothing,2090
31-12-2023 15:00,2738,2289,South,65,1154,731,Electronics,449
31-12-2023 16:00,2364,2165,West,64,1506,173,Furniture,199
31-12-2023 17:00,3708,1023,West,80,1407,461,Electronics,2685
31-12-2023 18:00,4985,2070,North,54,1896,195,Electronics,2915
31-12-2023 19:00,1694,2233,West,70,507,391,Electronics,-539
31-12-2023 20:00,1924,1259,South,79,623,276,Electronics,665
31-12-2023 21:00,1151,2657,North,72,1624,126,Electronics,-1506
31-12-2023 22:00,1585,1851,West,87,1489,920,Furniture,-266
31-12-2023 23:00,4948,1768,East,78,1334,404,Clothing,3180
01-01-2024 00:00,1912,2285,East,62,1616,822,Electronics,-373
01-01-2024 01:00,3321,2352,West,81,1908,969,Groceries,969
01-01-2024 02:00,2577,2710,North,97,1265,868,Clothing,-133
01-01-2024 03:00,1495,898,North,91,1603,929,Clothing,597
01-01-2024 04:00,4795,2946,North,76,1821,304,Groceries,1849
01-01-2024 05:00,3148,2169,South,83,530,966,Groceries,979
01-01-2024 06:00,1556,738,East,94,877,677,Groceries,818
01-01-2024 07:00,2105,2103,West,98,829,761,Groceries,2
01-01-2024 08:00,2552,1646,West,82,1822,778,Groceries,906
01-01-2024 09:00,3120,2057,East,53,781,319,Electronics,1063
01-01-2024 10:00,4085,2657,South,67,1535,399,Clothing,1428
01-01-2024 11:00,4504,1794,North,55,1138,357,Groceries,2710
01-01-2024 12:00,1156,799,East,77,1371,814,Groceries,357
01-01-2024 13:00,1734,2265,West,93,1198,339,Furniture,-531
01-01-2024 14:00,3179,1263,South,76,568,926,Clothing,1916
01-01-2024 15:00,4409,748,West,75,1340,328,Clothing,3661
01-01-2024 16:00,4066,533,North,69,522,573,Electronics,3533
01-01-2024 17:00,2427,727,East,62,836,255,Clothing,1700
01-01-2024 18:00,4447,1084,North,77,926,317,Groceries,3363
01-01-2024 19:00,4959,1223,South,83,1344,564,Furniture,3736
01-01-2024 20:00,1558,1069,East,98,708,294,Clothing,489
01-01-2024 21:00,3154,719,North,72,714,369,Furniture,2435
01-01-2024 22:00,4691,1894,North,59,1134,627,Groceries,2797
01-01-2024 23:00,3312,2622,North,79,922,852,Furniture,690
02-01-2024 00:00,4276,2141,South,71,572,863,Clothing,2135
02-01-2024 01:00,4150,635,North,54,1322,662,Clothing,3515
02-01-2024 02:00,1154,2621,West,93,1285,455,Electronics,-1467
02-01-2024 03:00,4854,753,East,99,1437,639,Groceries,4101
02-01-2024 04:00,4035,2454,East,58,1797,575,Electronics,1581
02-01-2024 05:00,1996,549,North,92,1756,664,Electronics,1447
02-01-2024 06:00,3294,1014,South,53,1564,407,Groceries,2280
02-01-2024 07:00,1530,2337,West,91,788,727,Clothing,-807
02-01-2024 08:00,3905,1075,West,50,1054,508,Furniture,2830
02-01-2024 09:00,2971,1665,East,83,1793,540,Electronics,1306
02-01-2024 10:00,3585,1402,East,90,938,620,Clothing,2183
02-01-2024 11:00,1728,2749,West,75,1837,622,Clothing,-1021
02-01-2024 12:00,2177,2754,East,67,1917,584,Electronics,-577
02-01-2024 13:00,1153,914,North,65,527,718,Electronics,239
02-01-2024 14:00,4757,2768,West,72,769,912,Electronics,1989
02-01-2024 15:00,1091,1604,East,95,1990,952,Clothing,-513
02-01-2024 16:00,4504,1262,North,85,573,357,Groceries,3242
02-01-2024 17:00,3385,1062,North,75,1173,793,Groceries,2323
02-01-2024 18:00,2503,2916,West,51,745,269,Electronics,-413
02-01-2024 19:00,2716,2015,North,93,909,560,Furniture,701
02-01-2024 20:00,4202,2434,West,54,997,936,Clothing,1768
02-01-2024 21:00,3497,1869,North,78,1941,750,Furniture,1628
02-01-2024 22:00,3016,703,West,53,1511,896,Electronics,2313
02-01-2024 23:00,3857,2076,West,96,710,210,Clothing,1781
03-01-2024 00:00,1786,568,West,84,1291,703,Groceries,1218
03-01-2024 01:00,1272,1015,West,71,1746,319,Groceries,257
03-01-2024 02:00,3027,2787,North,98,859,104,Furniture,240
03-01-2024 03:00,3635,860,West,57,1081,631,Electronics,2775
03-01-2024 04:00,1176,1964,East,93,1543,712,Furniture,-788
03-01-2024 05:00,4767,1554,North,70,922,394,Electronics,3213
03-01-2024 06:00,3878,2422,West,57,620,557,Groceries,1456
03-01-2024 07:00,1642,2152,North,54,672,768,Clothing,-510
03-01-2024 08:00,2898,1206,North,70,533,994,Groceries,1692
03-01-2024 09:00,4120,2125,North,76,1417,612,Furniture,1995
03-01-2024 10:00,1566,1156,North,87,570,311,Clothing,410
03-01-2024 11:00,1665,1845,West,54,1044,218,Electronics,-180
03-01-2024 12:00,4426,843,North,70,1273,484,Groceries,3583
03-01-2024 13:00,4783,1035,East,57,1283,359,Electronics,3748
03-01-2024 14:00,2331,854,North,71,1467,498,Groceries,1477
03-01-2024 15:00,3915,1427,North,67,1034,274,Electronics,2488
03-01-2024 16:00,4956,1482,East,53,513,513,Groceries,3474
03-01-2024 17:00,4701,2517,West,53,1829,233,Groceries,2184
03-01-2024 18:00,2798,2652,East,86,770,201,Electronics,146
03-01-2024 19:00,2069,1845,South,64,1576,484,Groceries,224
03-01-2024 20:00,3349,2095,East,87,962,554,Groceries,1254
03-01-2024 21:00,3915,2406,West,76,1022,161,Groceries,1509
03-01-2024 22:00,3959,1026,East,70,1269,665,Furniture,2933
03-01-2024 23:00,1407,1430,North,97,1354,916,Groceries,-23
04-01-2024 00:00,2212,2782,West,95,1291,106,Electronics,-570
04-01-2024 01:00,3869,2446,South,95,1847,967,Electronics,1423
04-01-2024 02:00,2853,1786,West,97,942,614,Furniture,1067
04-01-2024 03:00,2152,2416,North,53,750,431,Groceries,-264
04-01-2024 04:00,3608,2093,South,60,659,478,Furniture,1515
04-01-2024 05:00,4608,1873,West,68,535,544,Furniture,2735
04-01-2024 06:00,4337,1723,West,68,1379,434,Groceries,2614
04-01-2024 07:00,2141,2459,North,76,1721,567,Electronics,-318
04-01-2024 08:00,3511,1465,East,89,1973,760,Groceries,2046
04-01-2024 09:00,1143,1463,East,91,1901,387,Furniture,-320
04-01-2024 10:00,3489,1396,South,77,1769,111,Clothing,2093
04-01-2024 11:00,4271,1858,North,54,892,203,Furniture,2413
04-01-2024 12:00,4228,716,North,97,1727,722,Electronics,3512
04-01-2024 13:00,1486,1122,East,74,543,362,Groceries,364
04-01-2024 14:00,1859,852,East,52,814,534,Clothing,1007
04-01-2024 15:00,4205,1191,South,75,907,272,Furniture,3014
04-01-2024 16:00,2935,1130,East,59,1394,706,Furniture,1805
04-01-2024 17:00,1147,2872,South,73,705,420,Furniture,-1725
04-01-2024 18:00,2359,1668,West,78,1764,814,Groceries,691
04-01-2024 19:00,4142,2855,South,94,540,144,Groceries,1287
04-01-2024 20:00,4304,1153,South,56,1087,645,Furniture,3151
04-01-2024 21:00,2357,2832,South,93,1213,310,Groceries,-475
04-01-2024 22:00,3858,891,West,72,1886,836,Clothing,2967
04-01-2024 23:00,3713,2907,East,95,1397,516,Clothing,806
05-01-2024 00:00,1089,1268,South,76,594,363,Electronics,-179
05-01-2024 01:00,2357,1296,East,91,1039,400,Groceries,1061
05-01-2024 02:00,1198,1431,South,58,1667,555,Groceries,-233
05-01-2024 03:00,4232,2470,East,93,558,325,Furniture,1762
05-01-2024 04:00,1537,664,South,52,1353,203,Clothing,873
05-01-2024 05:00,4192,1232,East,62,1008,320,Groceries,2960
05-01-2024 06:00,1300,1080,North,55,1012,433,Groceries,220
05-01-2024 07:00,1723,1320,West,87,1298,517,Groceries,403
05-01-2024 08:00,2598,1747,South,70,1545,400,Furniture,851
05-01-2024 09:00,4010,623,West,68,1237,734,Clothing,3387
05-01-2024 10:00,2459,2471,South,74,1727,584,Groceries,-12
05-01-2024 11:00,1067,843,North,88,1198,556,Groceries,224
05-01-2024 12:00,4836,2374,North,53,1386,535,Furniture,2462
05-01-2024 13:00,4993,1023,West,71,970,493,Electronics,3970
05-01-2024 14:00,3506,628,South,54,783,833,Furniture,2878
05-01-2024 15:00,2537,1658,East,50,871,142,Groceries,879
05-01-2024 16:00,1397,2618,South,99,1855,309,Clothing,-1221
05-01-2024 17:00,1619,2820,East,66,1550,948,Clothing,-1201
05-01-2024 18:00,4357,1710,West,58,1354,110,Groceries,2647
05-01-2024 19:00,2584,1526,West,58,628,315,Electronics,1058
05-01-2024 20:00,2163,1808,North,73,1903,263,Furniture,355
05-01-2024 21:00,1729,521,East,59,1006,324,Groceries,1208
05-01-2024 22:00,1555,665,South,69,1618,836,Groceries,890
05-01-2024 23:00,2952,1833,North,66,1077,345,Groceries,1119
06-01-2024 00:00,3828,2000,West,62,1700,757,Furniture,1828
06-01-2024 01:00,4661,997,North,78,972,802,Clothing,3664
06-01-2024 02:00,2751,933,South,85,1507,872,Furniture,1818
06-01-2024 03:00,3941,2781,South,72,1798,898,Groceries,1160
06-01-2024 04:00,3657,1336,West,76,1167,115,Clothing,2321
06-01-2024 05:00,3795,2193,North,67,1946,293,Electronics,1602
06-01-2024 06:00,3329,1162,East,67,819,108,Groceries,2167
06-01-2024 07:00,3708,1224,East,58,557,613,Clothing,2484
06-01-2024 08:00,3971,875,East,52,772,392,Clothing,3096
06-01-2024 09:00,4887,802,South,56,1721,183,Clothing,4085
06-01-2024 10:00,1995,2952,North,64,1602,308,Groceries,-957
06-01-2024 11:00,2959,2186,East,79,1481,157,Electronics,773
06-01-2024 12:00,2601,1207,North,58,540,950,Clothing,1394
06-01-2024 13:00,3793,1416,West,90,1237,611,Groceries,2377
06-01-2024 14:00,2480,2568,East,76,1768,717,Clothing,-88
06-01-2024 15:00,3134,756,North,85,1546,747,Furniture,2378
06-01-2024 16:00,2102,898,South,67,1208,919,Clothing,1204
06-01-2024 17:00,4276,550,West,80,735,430,Groceries,3726
06-01-2024 18:00,3838,2994,West,66,625,560,Clothing,844
06-01-2024 19:00,4408,1094,West,55,1277,688,Clothing,3314
06-01-2024 20:00,4325,1317,West,88,1335,424,Furniture,3008
06-01-2024 21:00,3351,1135,South,74,639,309,Furniture,2216
06-01-2024 22:00,2403,1572,South,91,1378,843,Groceries,831
06-01-2024 23:00,3177,2152,East,91,893,224,Electronics,1025
07-01-2024 00:00,3643,1641,South,87,1327,791,Electronics,2002
07-01-2024 01:00,2299,1976,South,87,626,561,Electronics,323
07-01-2024 02:00,2722,1274,West,80,1637,389,Electronics,1448
07-01-2024 03:00,3605,2470,South,78,1336,313,Groceries,1135
07-01-2024 04:00,1898,2164,West,89,1024,531,Groceries,-266
07-01-2024 05:00,2206,896,North,58,1751,196,Furniture,1310
07-01-2024 06:00,4339,1895,North,50,645,348,Furniture,2444
07-01-2024 07:00,4879,1620,North,65,1686,602,Electronics,3259
07-01-2024 08:00,4393,1028,North,87,1234,832,Furniture,3365
07-01-2024 09:00,2535,1184,North,72,1227,624,Groceries,1351
07-01-2024 10:00,4683,2733,North,57,668,604,Electronics,1950
07-01-2024 11:00,1077,2762,North,96,1648,917,Clothing,-1685
07-01-2024 12:00,3831,2763,West,61,799,190,Clothing,1068
07-01-2024 13:00,4410,2576,West,59,1773,804,Clothing,1834
07-01-2024 14:00,3721,601,West,65,1437,810,Furniture,3120
07-01-2024 15:00,4627,622,West,96,1021,871,Electronics,4005
07-01-2024 16:00,2532,2601,South,92,604,675,Clothing,-69
07-01-2024 17:00,1237,1806,South,73,1117,941,Electronics,-569
07-01-2024 18:00,2157,2137,East,88,1468,843,Groceries,20
07-01-2024 19:00,2996,1640,South,57,1005,838,Clothing,1356
07-01-2024 20:00,2215,1115,West,60,801,266,Clothing,1100
07-01-2024 21:00,4427,1056,West,90,1152,350,Clothing,3371
07-01-2024 22:00,1277,613,North,75,1753,546,Groceries,664
07-01-2024 23:00,4089,2066,North,56,563,285,Electronics,2023
08-01-2024 00:00,1523,1476,East,64,1089,348,Clothing,47
08-01-2024 01:00,1179,1200,South,64,731,883,Clothing,-21
08-01-2024 02:00,1122,1816,West,97,1706,439,Electronics,-694
08-01-2024 03:00,2269,2839,South,52,818,545,Furniture,-570
08-01-2024 04:00,2757,760,East,65,1328,237,Furniture,1997
08-01-2024 05:00,4444,2596,North,64,591,208,Clothing,1848
08-01-2024 06:00,4122,1529,West,74,1460,929,Clothing,2593
08-01-2024 07:00,2094,878,North,82,563,516,Furniture,1216
08-01-2024 08:00,1479,2409,West,63,1343,525,Furniture,-930
08-01-2024 09:00,4631,2771,North,73,718,143,Clothing,1860
08-01-2024 10:00,4090,1546,North,60,1203,441,Electronics,2544
08-01-2024 11:00,2797,1507,East,52,1118,948,Furniture,1290
08-01-2024 12:00,3131,609,South,58,746,300,Clothing,2522
08-01-2024 13:00,4226,1922,North,55,1463,477,Groceries,2304
08-01-2024 14:00,3612,1505,West,80,1996,203,Electronics,2107
08-01-2024 15:00,3666,1197,South,65,1513,557,Clothing,2469
08-01-2024 16:00,3404,805,South,60,556,514,Groceries,2599
08-01-2024 17:00,1815,2105,North,99,1568,731,Furniture,-290
08-01-2024 18:00,3694,2231,North,66,1609,501,Groceries,1463
08-01-2024 19:00,1442,1458,North,98,1561,489,Groceries,-16
08-01-2024 20:00,4140,1453,South,52,681,461,Groceries,2687
08-01-2024 21:00,3570,1674,East,68,663,533,Furniture,1896
08-01-2024 22:00,1142,2130,North,73,1256,482,Groceries,-988
08-01-2024 23:00,1191,2291,South,96,625,127,Furniture,-1100
09-01-2024 00:00,2410,2471,South,91,1730,206,Clothing,-61
09-01-2024 01:00,1377,566,West,57,766,891,Groceries,811
09-01-2024 02:00,3628,1679,North,98,853,639,Electronics,1949
09-01-2024 03:00,1534,1334,East,85,1934,285,Clothing,200
09-01-2024 04:00,2716,705,West,89,1645,294,Furniture,2011
09-01-2024 05:00,4364,654,North,51,1109,245,Clothing,3710
09-01-2024 06:00,2032,2214,West,72,968,871,Groceries,-182
09-01-2024 07:00,4342,2032,North,89,1300,971,Furniture,2310
09-01-2024 08:00,2410,2095,West,79,632,788,Groceries,315
09-01-2024 09:00,3140,2545,East,74,1902,227,Clothing,595
09-01-2024 10:00,2989,1990,West,56,1511,995,Electronics,999
09-01-2024 11:00,3576,1207,West,77,1348,205,Clothing,2369
09-01-2024 12:00,2177,2434,West,90,1519,515,Clothing,-257
09-01-2024 13:00,1404,678,North,99,817,451,Groceries,726
09-01-2024 14:00,3887,1571,North,66,1210,482,Electronics,2316
09-01-2024 15:00,2172,1595,East,81,1648,822,Groceries,577
09-01-2024 16:00,1888,612,West,50,950,448,Groceries,1276
09-01-2024 17:00,4338,1256,South,76,1731,580,Groceries,3082
09-01-2024 18:00,1421,1396,West,93,1823,933,Furniture,25
09-01-2024 19:00,4911,2426,South,85,1132,413,Groceries,2485
09-01-2024 20:00,2641,658,South,98,641,622,Electronics,1983
09-01-2024 21:00,1471,1285,West,56,1503,978,Groceries,186
09-01-2024 22:00,3940,2303,South,52,1997,459,Groceries,1637
09-01-2024 23:00,1546,2339,South,79,1358,420,Electronics,-793
10-01-2024 00:00,1630,2798,West,50,1068,483,Clothing,-1168
10-01-2024 01:00,4597,2042,North,83,803,116,Groceries,2555
10-01-2024 02:00,4574,612,West,87,1156,469,Clothing,3962
10-01-2024 03:00,2037,758,East,92,1143,947,Groceries,1279
10-01-2024 04:00,3825,2654,South,85,1092,165,Groceries,1171
10-01-2024 05:00,4723,1074,East,82,529,985,Furniture,3649
10-01-2024 06:00,2829,1881,South,92,1900,212,Electronics,948
10-01-2024 07:00,1363,2306,North,65,1864,743,Electronics,-943
10-01-2024 08:00,3166,1722,South,87,1732,515,Clothing,1444
10-01-2024 09:00,4309,2974,West,60,1766,170,Furniture,1335
10-01-2024 10:00,1545,2001,South,57,1194,160,Groceries,-456
10-01-2024 11:00,4240,1358,East,50,657,543,Furniture,2882
10-01-2024 12:00,3569,2096,West,63,645,413,Electronics,1473
10-01-2024 13:00,1633,2061,East,79,839,582,Groceries,-428
10-01-2024 14:00,2936,2891,North,70,1365,343,Groceries,45
10-01-2024 15:00,2680,2683,East,70,591,920,Clothing,-3
10-01-2024 16:00,1962,776,East,83,828,616,Furniture,1186
10-01-2024 17:00,4005,2512,East,87,671,469,Groceries,1493
10-01-2024 18:00,4806,2578,West,75,1201,416,Electronics,2228
10-01-2024 19:00,1882,746,North,90,1554,120,Clothing,1136
10-01-2024 20:00,4840,910,North,63,1120,797,Electronics,3930
10-01-2024 21:00,3827,2574,North,89,771,820,Clothing,1253
10-01-2024 22:00,1870,572,East,84,1618,330,Furniture,1298
10-01-2024 23:00,1515,1620,West,91,1488,625,Clothing,-105
11-01-2024 00:00,3985,1172,West,67,576,963,Furniture,2813
11-01-2024 01:00,2420,1869,West,69,650,690,Furniture,551
11-01-2024 02:00,1865,1823,East,58,641,568,Groceries,42
11-01-2024 03:00,3153,786,North,90,730,793,Furniture,2367
11-01-2024 04:00,2108,2408,East,94,1453,177,Clothing,-300
11-01-2024 05:00,1213,711,West,82,627,908,Clothing,502
11-01-2024 06:00,4192,900,East,98,1359,883,Groceries,3292
11-01-2024 07:00,4203,1154,South,53,1195,662,Clothing,3049
11-01-2024 08:00,3897,997,North,53,996,868,Furniture,2900
11-01-2024 09:00,3244,1851,North,97,1803,907,Clothing,1393
11-01-2024 10:00,1018,597,West,65,1309,629,Electronics,421
11-01-2024 11:00,1641,2913,East,96,630,389,Electronics,-1272
11-01-2024 12:00,4083,962,West,75,1984,317,Groceries,3121
11-01-2024 13:00,2104,2575,East,55,768,199,Furniture,-471
11-01-2024 14:00,1329,772,South,86,1117,248,Clothing,557
11-01-2024 15:00,1865,1650,North,71,1461,484,Groceries,215
11-01-2024 16:00,1773,2749,North,91,1783,254,Groceries,-976
11-01-2024 17:00,1391,2997,East,88,1574,494,Furniture,-1606
11-01-2024 18:00,1636,1611,North,56,1656,475,Groceries,25
11-01-2024 19:00,3354,518,East,91,1308,201,Electronics,2836
11-01-2024 20:00,4338,2116,West,79,1528,726,Groceries,2222
11-01-2024 21:00,4518,1981,South,59,1147,881,Clothing,2537
11-01-2024 22:00,4512,2858,East,64,1237,191,Electronics,1654
11-01-2024 23:00,3942,911,South,55,1001,510,Electronics,3031
12-01-2024 00:00,3699,1241,West,73,1707,505,Electronics,2458
12-01-2024 01:00,3888,2791,West,51,908,120,Clothing,1097
12-01-2024 02:00,2025,1903,West,89,1614,731,Furniture,122
12-01-2024 03:00,3567,1014,East,64,1959,507,Groceries,2553
12-01-2024 04:00,4833,706,South,70,1319,118,Groceries,4127
12-01-2024 05:00,2674,1447,South,67,1402,635,Electronics,1227
12-01-2024 06:00,3683,2941,North,54,688,637,Electronics,742
12-01-2024 07:00,4380,2328,East,74,1480,252,Groceries,2052
12-01-2024 08:00,1739,2498,North,85,1314,400,Clothing,-759
12-01-2024 09:00,2545,2749,North,59,882,975,Electronics,-204
12-01-2024 10:00,1468,2667,East,95,1349,512,Electronics,-1199
12-01-2024 11:00,3259,2172,North,72,1845,301,Clothing,1087
12-01-2024 12:00,2135,2330,North,73,1966,238,Furniture,-195
12-01-2024 13:00,2031,2936,North,94,989,891,Electronics,-905
12-01-2024 14:00,3851,2060,West,59,1656,123,Furniture,1791
12-01-2024 15:00,3524,2347,East,55,925,111,Clothing,1177
12-01-2024 16:00,1873,2781,West,62,749,234,Groceries,-908
12-01-2024 17:00,1459,2156,North,70,1584,180,Groceries,-697
12-01-2024 18:00,3300,1101,North,81,1519,454,Furniture,2199
12-01-2024 19:00,2549,1843,West,92,1945,169,Electronics,706
12-01-2024 20:00,1751,1211,North,64,1999,303,Groceries,540
12-01-2024 21:00,2461,1481,East,51,1746,690,Clothing,980
12-01-2024 22:00,2777,1703,South,64,1961,378,Electronics,1074
12-01-2024 23:00,4028,1891,West,66,1183,810,Furniture,2137
13-01-2024 00:00,1853,2623,South,69,1907,478,Furniture,-770
13-01-2024 01:00,4732,1329,South,99,818,393,Furniture,3403
13-01-2024 02:00,3283,1049,South,55,1519,514,Furniture,2234
13-01-2024 03:00,2329,1145,West,64,724,896,Clothing,1184
13-01-2024 04:00,1477,1744,North,66,922,527,Groceries,-267
13-01-2024 05:00,3726,1345,East,75,1407,255,Furniture,2381
13-01-2024 06:00,4091,2600,North,71,1714,687,Groceries,1491
13-01-2024 07:00,3263,949,East,58,578,830,Groceries,2314
13-01-2024 08:00,3902,2609,North,61,1354,935,Furniture,1293
13-01-2024 09:00,1134,543,South,71,1503,376,Electronics,591
13-01-2024 10:00,3952,2081,South,72,864,364,Furniture,1871
13-01-2024 11:00,2152,1158,East,86,521,148,Clothing,994
13-01-2024 12:00,1409,1227,West,63,1047,709,Electronics,182
13-01-2024 13:00,2445,2594,North,73,829,392,Furniture,-149
13-01-2024 14:00,2317,1547,South,57,1679,120,Groceries,770
13-01-2024 15:00,2269,2180,East,75,555,543,Groceries,89
13-01-2024 16:00,4772,2636,North,81,1771,634,Electronics,2136
13-01-2024 17:00,2579,1697,East,77,1424,571,Clothing,882
13-01-2024 18:00,1085,1642,West,81,760,237,Groceries,-557
13-01-2024 19:00,3603,2191,West,71,934,329,Clothing,1412
13-01-2024 20:00,2865,2725,North,98,1037,937,Groceries,140
13-01-2024 21:00,4446,2355,West,58,1034,504,Electronics,2091
13-01-2024 22:00,2469,2447,North,52,880,456,Furniture,22
13-01-2024 23:00,1377,1865,North,74,602,640,Groceries,-488
14-01-2024 00:00,4461,937,West,88,528,926,Electronics,3524
14-01-2024 01:00,2680,1951,East,61,1580,120,Electronics,729
14-01-2024 02:00,2074,925,East,78,1585,953,Furniture,1149
14-01-2024 03:00,1241,1467,North,52,1454,710,Furniture,-226
14-01-2024 04:00,4365,1904,South,90,1571,674,Electronics,2461
14-01-2024 05:00,1919,985,North,95,1890,913,Groceries,934
14-01-2024 06:00,2586,2255,East,72,1046,744,Clothing,331
14-01-2024 07:00,3313,2079,North,72,826,626,Clothing,1234
14-01-2024 08:00,4191,2396,East,67,765,204,Furniture,1795
14-01-2024 09:00,3759,550,West,60,1228,722,Groceries,3209
14-01-2024 10:00,4988,2856,North,85,1699,950,Electronics,2132
14-01-2024 11:00,2271,1557,North,75,1567,435,Clothing,714
14-01-2024 12:00,1069,2159,West,57,718,523,Clothing,-1090
14-01-2024 13:00,4924,2112,West,77,625,722,Groceries,2812
14-01-2024 14:00,3104,2427,South,67,1381,974,Electronics,677
14-01-2024 15:00,2405,704,West,62,1902,954,Furniture,1701
14-01-2024 16:00,3086,1593,South,85,818,103,Clothing,1493
14-01-2024 17:00,3007,1032,West,91,1828,568,Groceries,1975
14-01-2024 18:00,1800,2655,East,89,1723,763,Furniture,-855
14-01-2024 19:00,4514,1764,North,93,584,653,Groceries,2750
14-01-2024 20:00,2041,750,West,61,1564,986,Electronics,1291
14-01-2024 21:00,3779,634,East,71,1222,637,Groceries,3145
14-01-2024 22:00,1824,2114,West,51,1886,973,Furniture,-290
14-01-2024 23:00,1755,906,North,89,1792,293,Electronics,849
15-01-2024 00:00,3399,601,West,77,861,459,Clothing,2798
15-01-2024 01:00,2995,1884,West,62,866,619,Furniture,1111
15-01-2024 02:00,2839,2051,North,82,1704,172,Groceries,788
15-01-2024 03:00,2321,2131,West,52,1754,177,Clothing,190
15-01-2024 04:00,3330,1816,North,83,1487,759,Electronics,1514
15-01-2024 05:00,2609,903,South,72,1593,933,Furniture,1706
15-01-2024 06:00,1109,1313,West,81,1087,167,Electronics,-204
15-01-2024 07:00,2016,2129,East,69,1462,966,Electronics,-113
15-01-2024 08:00,4251,1526,West,77,988,794,Groceries,2725
15-01-2024 09:00,2961,1520,North,57,1757,433,Groceries,1441
15-01-2024 10:00,3591,2724,North,52,1952,184,Groceries,867
15-01-2024 11:00,2769,1780,East,79,1330,595,Clothing,989
15-01-2024 12:00,4865,2945,East,74,1165,178,Clothing,1920
15-01-2024 13:00,1024,2019,North,79,1817,650,Groceries,-995
15-01-2024 14:00,1842,719,South,78,1871,405,Clothing,1123
15-01-2024 15:00,3838,2504,South,96,1622,119,Furniture,1334
15-01-2024 16:00,1737,672,North,79,1375,681,Electronics,1065
15-01-2024 17:00,3104,1913,South,83,860,255,Groceries,1191
15-01-2024 18:00,1179,1001,East,74,857,216,Electronics,178
15-01-2024 19:00,1231,2312,South,66,1653,979,Electronics,-1081
15-01-2024 20:00,2917,2678,East,73,1906,549,Electronics,239
15-01-2024 21:00,1342,1297,West,87,1235,127,Furniture,45
15-01-2024 22:00,1476,1429,East,77,563,986,Furniture,47
15-01-2024 23:00,2822,1222,West,82,1919,709,Clothing,1600
16-01-2024 00:00,3623,2762,East,85,680,428,Electronics,861
16-01-2024 01:00,1454,1833,East,56,1086,762,Clothing,-379
16-01-2024 02:00,2255,1774,South,72,688,463,Electronics,481
16-01-2024 03:00,1288,987,East,95,1706,518,Groceries,301
16-01-2024 04:00,2236,2457,North,75,1079,121,Electronics,-221
16-01-2024 05:00,3305,1717,West,63,669,360,Electronics,1588
16-01-2024 06:00,1529,1964,West,91,821,159,Furniture,-435
16-01-2024 07:00,3734,812,East,77,1695,512,Groceries,2922
16-01-2024 08:00,3976,578,North,73,783,262,Clothing,3398
16-01-2024 09:00,3276,2727,East,56,865,213,Groceries,549
16-01-2024 10:00,4297,1174,East,97,610,453,Furniture,3123
16-01-2024 11:00,1595,2237,South,85,577,295,Furniture,-642
16-01-2024 12:00,4874,513,East,88,752,144,Electronics,4361
16-01-2024 13:00,1434,2793,East,64,735,724,Furniture,-1359
16-01-2024 14:00,1881,2545,South,98,592,278,Furniture,-664
16-01-2024 15:00,4068,1537,South,52,1557,881,Electronics,2531
16-01-2024 16:00,2781,2646,North,97,1927,592,Furniture,135
16-01-2024 17:00,1401,532,South,51,721,424,Furniture,869
16-01-2024 18:00,3669,1959,West,56,1395,469,Clothing,1710
16-01-2024 19:00,4837,756,West,65,1863,667,Electronics,4081
16-01-2024 20:00,3135,533,North,70,1460,978,Electronics,2602
16-01-2024 21:00,3631,2566,East,58,1484,446,Clothing,1065
16-01-2024 22:00,4964,1783,North,61,1342,878,Clothing,3181
16-01-2024 23:00,2565,2349,South,78,751,214,Clothing,216
17-01-2024 00:00,4755,2684,East,73,1887,456,Clothing,2071
17-01-2024 01:00,1308,858,North,82,641,266,Electronics,450
17-01-2024 02:00,3953,1253,North,63,810,453,Clothing,2700
17-01-2024 03:00,1342,2102,West,92,1908,214,Clothing,-760
17-01-2024 04:00,1435,903,North,67,1081,507,Furniture,532
17-01-2024 05:00,1176,1725,East,54,1835,691,Electronics,-549
17-01-2024 06:00,1138,1899,North,64,1802,925,Clothing,-761
17-01-2024 07:00,1193,2797,North,56,845,897,Furniture,-1604
17-01-2024 08:00,4257,2993,South,74,1910,422,Electronics,1264
17-01-2024 09:00,4289,777,North,63,801,640,Clothing,3512
17-01-2024 10:00,4235,611,East,89,1006,141,Clothing,3624
17-01-2024 11:00,2184,2486,West,85,746,559,Furniture,-302
17-01-2024 12:00,1942,891,West,84,987,218,Groceries,1051
17-01-2024 13:00,1524,1468,West,93,1762,673,Electronics,56
17-01-2024 14:00,4879,2690,West,99,1427,766,Furniture,2189
17-01-2024 15:00,2624,1555,South,73,1872,896,Clothing,1069
17-01-2024 16:00,4907,2728,East,64,1290,549,Groceries,2179
17-01-2024 17:00,4113,768,South,60,1411,540,Groceries,3345
17-01-2024 18:00,3962,2529,West,73,1875,288,Furniture,1433
17-01-2024 19:00,3257,774,South,60,653,384,Furniture,2483
17-01-2024 20:00,1740,1242,North,93,1709,203,Furniture,498
17-01-2024 21:00,1861,585,East,66,1443,668,Electronics,1276
17-01-2024 22:00,4346,903,North,55,1094,556,Groceries,3443
17-01-2024 23:00,1953,2739,South,70,1948,410,Electronics,-786
18-01-2024 00:00,2302,2545,North,57,561,983,Groceries,-243
18-01-2024 01:00,2274,1554,South,64,1924,783,Electronics,720
18-01-2024 02:00,4381,2654,South,81,1369,483,Furniture,1727
18-01-2024 03:00,2743,2394,East,59,1582,767,Clothing,349
18-01-2024 04:00,3880,775,East,77,1665,264,Furniture,3105
18-01-2024 05:00,3187,1150,East,64,965,506,Electronics,2037
18-01-2024 06:00,1791,2121,West,61,1672,944,Furniture,-330
18-01-2024 07:00,1545,1605,East,92,1970,680,Groceries,-60
18-01-2024 08:00,2844,2413,North,67,1697,575,Electronics,431
18-01-2024 09:00,2016,1085,East,86,810,157,Furniture,931
18-01-2024 10:00,2927,628,East,93,1585,818,Furniture,2299
18-01-2024 11:00,2553,755,East,73,1690,515,Clothing,1798
18-01-2024 12:00,1056,730,South,86,1315,696,Clothing,326
18-01-2024 13:00,3159,1660,South,78,602,936,Furniture,1499
18-01-2024 14:00,1004,2902,East,59,527,712,Groceries,-1898
18-01-2024 15:00,4481,2147,South,63,1007,903,Groceries,2334
18-01-2024 16:00,2437,2693,South,65,633,350,Groceries,-256
18-01-2024 17:00,4253,2547,West,86,558,319,Furniture,1706
18-01-2024 18:00,4084,759,North,60,1613,259,Clothing,3325
18-01-2024 19:00,2362,2634,South,75,569,286,Furniture,-272
18-01-2024 20:00,2820,1342,North,89,684,995,Clothing,1478
18-01-2024 21:00,2282,2471,South,68,1961,698,Groceries,-189
18-01-2024 22:00,3137,764,East,67,1071,563,Clothing,2373
18-01-2024 23:00,3663,891,South,79,1997,597,Furniture,2772
19-01-2024 00:00,3938,2779,South,81,667,429,Furniture,1159
19-01-2024 01:00,3745,1400,North,72,1077,448,Furniture,2345
19-01-2024 02:00,2273,1087,East,61,1647,599,Clothing,1186
19-01-2024 03:00,4326,2994,West,62,1736,766,Groceries,1332
19-01-2024 04:00,4659,1652,North,70,681,966,Furniture,3007
19-01-2024 05:00,3945,1794,East,70,570,589,Furniture,2151
19-01-2024 06:00,4018,965,East,78,1055,379,Clothing,3053
19-01-2024 07:00,2131,1693,North,78,1351,954,Groceries,438
19-01-2024 08:00,1667,2675,South,99,1718,934,Clothing,-1008
19-01-2024 09:00,3641,2472,East,76,1815,263,Electronics,1169
19-01-2024 10:00,3636,1549,West,78,1580,497,Electronics,2087
19-01-2024 11:00,3532,987,South,64,1182,167,Furniture,2545
19-01-2024 12:00,4029,1449,North,96,1823,527,Clothing,2580
19-01-2024 13:00,4019,905,North,61,817,531,Clothing,3114
19-01-2024 14:00,2281,1549,North,90,1894,973,Furniture,732
19-01-2024 15:00,3686,1606,North,68,1606,474,Electronics,2080
19-01-2024 16:00,1996,863,West,61,1328,899,Groceries,1133
19-01-2024 17:00,2926,1890,West,72,593,823,Groceries,1036
19-01-2024 18:00,1281,1583,East,54,766,731,Electronics,-302
19-01-2024 19:00,4033,1050,West,75,1899,796,Furniture,2983
19-01-2024 20:00,4159,2158,North,59,1684,522,Furniture,2001
19-01-2024 21:00,2227,791,West,71,1113,827,Groceries,1436
19-01-2024 22:00,3063,2460,South,88,1001,741,Groceries,603
19-01-2024 23:00,4222,2317,South,72,1900,177,Electronics,1905
20-01-2024 00:00,1935,690,East,60,1635,587,Electronics,1245
20-01-2024 01:00,1253,960,North,77,1077,269,Clothing,293
20-01-2024 02:00,2211,2419,West,80,1131,137,Electronics,-208
20-01-2024 03:00,1328,2780,East,57,778,666,Electronics,-1452
20-01-2024 04:00,3591,770,East,88,1253,389,Groceries,2821
20-01-2024 05:00,3830,1657,West,97,1956,657,Groceries,2173
20-01-2024 06:00,4044,670,East,77,741,270,Clothing,3374
20-01-2024 07:00,2420,1938,North,65,1745,741,Groceries,482
20-01-2024 08:00,2540,527,West,95,1282,775,Groceries,2013
20-01-2024 09:00,4530,635,South,96,1461,681,Groceries,3895
20-01-2024 10:00,4401,2952,South,80,1809,391,Electronics,1449
20-01-2024 11:00,4891,1387,West,90,1484,680,Groceries,3504
20-01-2024 12:00,3892,2028,East,97,503,521,Furniture,1864
20-01-2024 13:00,2192,1764,East,65,819,204,Electronics,428
20-01-2024 14:00,2716,1355,South,54,1844,665,Groceries,1361
20-01-2024 15:00,3413,2991,South,84,1531,505,Electronics,422
20-01-2024 16:00,2201,2981,North,74,1575,979,Groceries,-780
20-01-2024 17:00,1654,1751,East,62,1523,558,Clothing,-97
20-01-2024 18:00,2385,1008,North,78,1665,974,Clothing,1377
20-01-2024 19:00,1759,1826,South,76,1278,347,Clothing,-67
20-01-2024 20:00,3686,2581,South,89,1326,408,Groceries,1105
20-01-2024 21:00,2798,1525,South,66,779,472,Clothing,1273
20-01-2024 22:00,2063,861,South,86,1611,205,Electronics,1202
20-01-2024 23:00,3971,1718,North,87,1683,960,Clothing,2253
21-01-2024 00:00,1415,1105,South,78,1484,414,Clothing,310
21-01-2024 01:00,4426,2363,West,83,527,708,Clothing,2063
21-01-2024 02:00,1254,1831,East,79,1309,953,Clothing,-577
21-01-2024 03:00,2166,2170,South,80,771,638,Electronics,-4
21-01-2024 04:00,4823,1215,East,71,1623,171,Furniture,3608
21-01-2024 05:00,4811,2797,South,95,1727,477,Clothing,2014
21-01-2024 06:00,2876,2694,North,74,689,595,Groceries,182
21-01-2024 07:00,3757,847,East,53,1045,284,Furniture,2910
21-01-2024 08:00,3624,1777,North,84,793,233,Clothing,1847
21-01-2024 09:00,1899,898,South,90,1347,273,Furniture,1001
21-01-2024 10:00,3058,1857,West,99,1867,892,Groceries,1201
21-01-2024 11:00,4691,1699,West,93,1270,709,Groceries,2992
21-01-2024 12:00,1025,2672,West,58,1268,492,Clothing,-1647
21-01-2024 13:00,4004,2945,West,75,552,163,Clothing,1059
21-01-2024 14:00,1420,2678,West,76,1183,514,Groceries,-1258
21-01-2024 15:00,4734,2085,North,76,1570,502,Electronics,2649
21-01-2024 16:00,2244,1321,West,67,1510,212,Furniture,923
21-01-2024 17:00,2876,1401,South,79,1945,164,Electronics,1475
21-01-2024 18:00,3543,1444,North,94,1202,827,Clothing,2099
21-01-2024 19:00,2260,2369,North,95,1382,965,Electronics,-109
21-01-2024 20:00,3284,833,West,80,964,500,Electronics,2451
21-01-2024 21:00,2008,1543,East,91,1052,389,Furniture,465
21-01-2024 22:00,1218,2752,South,52,1416,582,Clothing,-1534
21-01-2024 23:00,2510,854,North,78,1952,519,Furniture,1656
22-01-2024 00:00,2959,1696,South,56,1507,414,Groceries,1263
22-01-2024 01:00,3508,1712,East,67,1920,188,Furniture,1796
22-01-2024 02:00,1662,1323,North,65,693,858,Furniture,339
22-01-2024 03:00,3682,1525,South,98,565,943,Groceries,2157
22-01-2024 04:00,4215,2396,West,81,1054,760,Electronics,1819
22-01-2024 05:00,1989,667,North,87,1100,456,Furniture,1322
22-01-2024 06:00,1188,2915,North,74,1999,977,Groceries,-1727
22-01-2024 07:00,1254,1035,North,93,1549,851,Clothing,219
22-01-2024 08:00,1067,2448,North,81,1622,617,Electronics,-1381
22-01-2024 09:00,1615,2119,West,68,975,848,Groceries,-504
22-01-2024 10:00,3383,1449,East,52,1072,464,Electronics,1934
22-01-2024 11:00,3718,706,East,84,1261,366,Groceries,3012
22-01-2024 12:00,3868,1043,South,99,1386,947,Furniture,2825
22-01-2024 13:00,1873,628,West,78,1329,505,Electronics,1245
22-01-2024 14:00,4480,1970,West,60,581,849,Furniture,2510
22-01-2024 15:00,3347,2582,South,55,1921,238,Groceries,765
22-01-2024 16:00,4979,2746,West,68,1199,264,Furniture,2233
22-01-2024 17:00,2625,2336,West,86,1916,893,Furniture,289
22-01-2024 18:00,1356,576,North,94,543,796,Groceries,780
22-01-2024 19:00,1255,868,North,76,1323,765,Furniture,387
22-01-2024 20:00,2007,1025,North,54,1109,205,Furniture,982
22-01-2024 21:00,3400,848,West,75,1614,248,Furniture,2552
22-01-2024 22:00,2755,1005,West,84,1852,284,Clothing,1750
22-01-2024 23:00,4592,1142,East,68,1937,509,Clothing,3450
23-01-2024 00:00,3571,737,North,66,1219,882,Clothing,2834
23-01-2024 01:00,4908,1803,South,84,1190,970,Electronics,3105
23-01-2024 02:00,3997,2100,West,96,1198,802,Furniture,1897
23-01-2024 03:00,3803,1955,North,98,1336,774,Furniture,1848
23-01-2024 04:00,4765,2685,East,62,609,300,Furniture,2080
23-01-2024 05:00,1283,2173,North,63,718,717,Electronics,-890
23-01-2024 06:00,4383,2346,East,79,962,826,Electronics,2037
23-01-2024 07:00,1098,2354,East,97,1359,935,Groceries,-1256
23-01-2024 08:00,1196,854,West,92,1014,319,Furniture,342
23-01-2024 09:00,3529,1058,East,66,1136,956,Groceries,2471
23-01-2024 10:00,1877,2417,East,86,1780,569,Groceries,-540
23-01-2024 11:00,4297,1754,South,64,1716,828,Electronics,2543
23-01-2024 12:00,2868,2181,East,67,1126,533,Clothing,687
23-01-2024 13:00,3662,1669,South,97,569,128,Electronics,1993
23-01-2024 14:00,3665,1675,South,63,958,849,Electronics,1990
23-01-2024 15:00,2388,2314,North,63,1905,163,Clothing,74
23-01-2024 16:00,3415,2687,North,94,596,195,Clothing,728
23-01-2024 17:00,1569,1162,West,82,723,765,Electronics,407
23-01-2024 18:00,3637,520,West,87,1330,639,Furniture,3117
23-01-2024 19:00,4146,2611,West,60,1804,609,Groceries,1535
23-01-2024 20:00,2065,1741,East,60,1856,439,Furniture,324
23-01-2024 21:00,1421,661,North,97,1140,787,Groceries,760
23-01-2024 22:00,3883,629,East,75,1928,350,Furniture,3254
23-01-2024 23:00,2204,2450,North,52,995,805,Clothing,-246
24-01-2024 00:00,1544,724,East,74,1709,378,Furniture,820
24-01-2024 01:00,1070,2281,West,66,1561,138,Electronics,-1211
24-01-2024 02:00,4639,1079,North,71,1268,168,Groceries,3560
24-01-2024 03:00,4176,1977,North,78,1259,376,Groceries,2199
24-01-2024 04:00,2223,606,South,95,987,219,Furniture,1617
24-01-2024 05:00,4172,1339,North,75,1055,185,Clothing,2833
24-01-2024 06:00,1767,1664,North,83,1491,276,Electronics,103
24-01-2024 07:00,3354,1657,East,75,988,705,Clothing,1697
24-01-2024 08:00,4657,2746,West,58,556,191,Electronics,1911
24-01-2024 09:00,2706,1166,South,89,1011,519,Electronics,1540
24-01-2024 10:00,3424,2626,East,60,1771,180,Electronics,798
24-01-2024 11:00,1654,2471,North,56,603,440,Furniture,-817
24-01-2024 12:00,3725,1011,East,79,1056,520,Electronics,2714
24-01-2024 13:00,3446,749,West,51,559,327,Electronics,2697
24-01-2024 14:00,2796,1388,South,79,1234,994,Electronics,1408
24-01-2024 15:00,1220,1523,East,53,1761,572,Groceries,-303
24-01-2024 16:00,4666,1098,North,63,870,187,Groceries,3568
24-01-2024 17:00,1181,1252,East,62,525,449,Furniture,-71
24-01-2024 18:00,1306,1099,North,74,892,739,Furniture,207
24-01-2024 19:00,3569,2719,South,62,1105,909,Groceries,850
24-01-2024 20:00,2419,2564,South,62,609,289,Groceries,-145
24-01-2024 21:00,2013,2258,East,86,1915,966,Electronics,-245
24-01-2024 22:00,3051,1817,South,93,1272,745,Groceries,1234
24-01-2024 23:00,3910,2941,West,55,753,235,Furniture,969
25-01-2024 00:00,4985,2345,East,75,1416,424,Furniture,2640
25-01-2024 01:00,1847,1742,North,63,1265,139,Electronics,105
25-01-2024 02:00,1803,733,East,57,1620,749,Clothing,1070
25-01-2024 03:00,4352,1913,North,73,1037,386,Clothing,2439
25-01-2024 04:00,1214,2795,South,71,1627,355,Groceries,-1581
25-01-2024 05:00,4019,2425,North,89,1114,897,Electronics,1594
25-01-2024 06:00,4681,2599,North,88,1086,696,Groceries,2082
25-01-2024 07:00,2443,2562,North,98,1096,519,Electronics,-119
25-01-2024 08:00,1100,940,North,70,1737,928,Groceries,160
25-01-2024 09:00,4010,1635,West,92,612,638,Furniture,2375
25-01-2024 10:00,4592,506,North,75,1835,841,Furniture,4086
25-01-2024 11:00,1572,2086,East,59,1068,390,Clothing,-514
25-01-2024 12:00,2332,1325,West,62,1454,415,Clothing,1007
25-01-2024 13:00,1657,1768,North,91,1395,899,Groceries,-111
25-01-2024 14:00,3986,1810,North,63,1624,957,Furniture,2176
25-01-2024 15:00,2533,2127,North,58,1261,231,Groceries,406
25-01-2024 16:00,4134,1536,West,56,1437,702,Furniture,2598
25-01-2024 17:00,2656,1669,North,88,1152,967,Electronics,987
25-01-2024 18:00,1225,977,North,80,583,840,Furniture,248
25-01-2024 19:00,1104,1214,North,99,1218,638,Clothing,-110
25-01-2024 20:00,2997,2176,South,65,1367,402,Furniture,821
25-01-2024 21:00,1771,2662,East,57,1448,381,Groceries,-891
25-01-2024 22:00,4932,1008,North,97,801,591,Electronics,3924
25-01-2024 23:00,4496,2604,East,64,1740,379,Clothing,1892
26-01-2024 00:00,4326,881,South,74,1067,599,Electronics,3445
26-01-2024 01:00,1428,1680,South,96,1040,298,Clothing,-252
26-01-2024 02:00,1433,2345,North,87,591,474,Clothing,-912
26-01-2024 03:00,2230,1686,East,90,1153,399,Electronics,544
26-01-2024 04:00,4099,774,West,64,1975,765,Electronics,3325
26-01-2024 05:00,3729,2218,North,74,1113,398,Furniture,1511
26-01-2024 06:00,4407,1600,West,56,570,654,Furniture,2807
26-01-2024 07:00,3635,2360,South,75,1924,421,Clothing,1275
26-01-2024 08:00,4699,2591,South,57,1168,209,Furniture,2108
26-01-2024 09:00,4140,1217,East,67,580,722,Furniture,2923
26-01-2024 10:00,1865,817,West,70,1623,570,Clothing,1048
26-01-2024 11:00,3793,1033,West,65,1094,511,Furniture,2760
26-01-2024 12:00,4584,2108,North,96,717,612,Electronics,2476
26-01-2024 13:00,4238,2276,East,52,1383,579,Groceries,1962
26-01-2024 14:00,3911,2784,East,50,1248,239,Electronics,1127
26-01-2024 15:00,4801,1744,West,62,624,977,Groceries,3057
26-01-2024 16:00,4856,1833,South,81,700,789,Electronics,3023
26-01-2024 17:00,3415,1700,East,61,1525,603,Groceries,1715
26-01-2024 18:00,1250,2294,South,80,1073,159,Groceries,-1044
26-01-2024 19:00,3906,2585,North,90,1543,282,Furniture,1321
26-01-2024 20:00,1855,1954,East,51,1482,518,Clothing,-99
26-01-2024 21:00,4757,2433,East,90,1221,893,Electronics,2324
26-01-2024 22:00,2193,1246,North,57,1451,924,Furniture,947
26-01-2024 23:00,4829,1340,East,74,679,832,Electronics,3489
27-01-2024 00:00,4161,2995,West,54,1932,326,Electronics,1166
27-01-2024 01:00,1560,2018,West,94,1585,490,Groceries,-458
27-01-2024 02:00,2469,2672,North,51,772,243,Groceries,-203
27-01-2024 03:00,3341,1588,South,91,1306,835,Clothing,1753
27-01-2024 04:00,1918,1292,South,87,1262,663,Groceries,626
27-01-2024 05:00,2173,1767,East,88,1533,692,Electronics,406
27-01-2024 06:00,4203,2050,South,52,1198,760,Groceries,2153
27-01-2024 07:00,1432,2773,South,95,1420,126,Furniture,-1341
27-01-2024 08:00,3106,792,North,97,1121,843,Furniture,2314
27-01-2024 09:00,1968,1904,South,87,1039,722,Groceries,64
27-01-2024 10:00,1835,2148,South,71,1485,607,Clothing,-313
27-01-2024 11:00,3246,2713,South,89,959,983,Groceries,533
27-01-2024 12:00,3262,1741,West,82,1584,690,Furniture,1521
27-01-2024 13:00,1897,1575,West,81,1581,890,Electronics,322
27-01-2024 14:00,4632,1897,North,96,799,226,Electronics,2735
27-01-2024 15:00,1471,2193,East,66,996,555,Electronics,-722
27-01-2024 16:00,4815,1537,North,67,1862,380,Furniture,3278
27-01-2024 17:00,1246,1863,East,52,1775,494,Furniture,-617
27-01-2024 18:00,3429,2062,East,55,1930,418,Electronics,1367
27-01-2024 19:00,1990,1612,South,98,1779,540,Clothing,378
27-01-2024 20:00,4310,2588,South,62,1904,440,Clothing,1722
27-01-2024 21:00,1926,1791,North,80,1668,793,Electronics,135
27-01-2024 22:00,4438,1661,North,66,1090,218,Electronics,2777
27-01-2024 23:00,2191,1529,North,70,840,877,Furniture,662
28-01-2024 00:00,3607,741,West,65,902,789,Groceries,2866
28-01-2024 01:00,2074,661,West,66,787,812,Furniture,1413
28-01-2024 02:00,2834,1478,West,81,1488,467,Groceries,1356
28-01-2024 03:00,4681,1017,West,50,713,484,Groceries,3664
28-01-2024 04:00,4799,1397,West,97,1031,609,Groceries,3402
28-01-2024 05:00,1688,1282,South,87,1369,681,Groceries,406
28-01-2024 06:00,3427,1679,East,57,1241,257,Electronics,1748
28-01-2024 07:00,3521,584,West,50,710,922,Groceries,2937
28-01-2024 08:00,4151,2235,North,51,670,709,Groceries,1916
28-01-2024 09:00,3744,1533,East,96,1037,816,Groceries,2211
28-01-2024 10:00,4438,637,West,86,1786,185,Furniture,3801
28-01-2024 11:00,2484,1253,West,73,1301,460,Furniture,1231
28-01-2024 12:00,3958,1212,South,76,1175,891,Furniture,2746
28-01-2024 13:00,4610,2703,South,69,889,184,Clothing,1907
28-01-2024 14:00,4523,2955,South,96,920,458,Furniture,1568
28-01-2024 15:00,4535,1079,West,70,561,826,Clothing,3456
28-01-2024 16:00,1959,1053,South,91,585,232,Furniture,906
28-01-2024 17:00,1477,895,West,86,1512,486,Clothing,582
28-01-2024 18:00,4051,2437,East,84,990,346,Furniture,1614
28-01-2024 19:00,3973,2186,East,87,1395,240,Electronics,1787
28-01-2024 20:00,4491,2119,West,64,559,546,Furniture,2372
28-01-2024 21:00,1706,1657,North,99,976,175,Clothing,49
28-01-2024 22:00,4285,1832,West,95,819,197,Groceries,2453
28-01-2024 23:00,4440,2389,East,91,1189,402,Furniture,2051
29-01-2024 00:00,3901,1309,East,79,551,565,Groceries,2592
29-01-2024 01:00,2137,669,West,53,1156,154,Groceries,1468
29-01-2024 02:00,4064,2837,West,92,1327,404,Furniture,1227
29-01-2024 03:00,1753,1239,West,88,1600,870,Furniture,514
29-01-2024 04:00,3550,2341,East,64,618,633,Electronics,1209
29-01-2024 05:00,2659,956,North,72,1220,134,Clothing,1703
29-01-2024 06:00,3864,1825,West,90,1705,639,Furniture,2039
29-01-2024 07:00,1587,2593,East,64,1005,588,Clothing,-1006
29-01-2024 08:00,2334,2101,West,75,1136,781,Furniture,233
29-01-2024 09:00,2492,1883,East,61,652,239,Groceries,609
29-01-2024 10:00,2847,1784,West,67,1541,740,Groceries,1063
29-01-2024 11:00,3755,1646,East,55,1587,199,Furniture,2109
29-01-2024 12:00,4934,730,West,67,996,472,Clothing,4204
29-01-2024 13:00,4115,611,South,99,578,858,Clothing,3504
29-01-2024 14:00,4486,1092,West,73,558,122,Groceries,3394
29-01-2024 15:00,4769,2938,East,87,1934,968,Clothing,1831
29-01-2024 16:00,4926,2939,West,77,1262,383,Clothing,1987
29-01-2024 17:00,4317,2875,North,64,1325,212,Electronics,1442
29-01-2024 18:00,4155,1738,West,68,1584,472,Groceries,2417
29-01-2024 19:00,1206,2387,West,54,1990,296,Clothing,-1181
29-01-2024 20:00,3198,2914,West,53,1602,263,Electronics,284
29-01-2024 21:00,3715,2629,North,66,743,992,Furniture,1086
29-01-2024 22:00,3575,1599,North,59,707,921,Electronics,1976
29-01-2024 23:00,1164,2026,North,61,1355,530,Electronics,-862
30-01-2024 00:00,3964,2469,South,54,1610,667,Electronics,1495
30-01-2024 01:00,2998,1451,North,56,1099,109,Electronics,1547
30-01-2024 02:00,4216,2002,South,93,1144,744,Electronics,2214
30-01-2024 03:00,4057,871,West,72,538,497,Electronics,3186
30-01-2024 04:00,3084,2811,South,51,1699,251,Furniture,273
30-01-2024 05:00,1332,609,West,79,977,290,Furniture,723
30-01-2024 06:00,1402,2854,South,98,519,895,Groceries,-1452
30-01-2024 07:00,1413,1723,North,94,720,376,Groceries,-310
30-01-2024 08:00,1044,725,North,86,774,592,Furniture,319
30-01-2024 09:00,4473,2732,South,54,1677,342,Furniture,1741
30-01-2024 10:00,3253,530,South,69,962,587,Groceries,2723
30-01-2024 11:00,1061,1113,North,75,1932,943,Electronics,-52
30-01-2024 12:00,3467,2294,West,93,750,375,Clothing,1173
30-01-2024 13:00,1867,598,West,93,711,289,Electronics,1269
30-01-2024 14:00,2491,1862,West,88,1186,726,Furniture,629
30-01-2024 15:00,3867,1310,West,55,918,963,Groceries,2557
30-01-2024 16:00,1018,2320,East,78,1695,406,Groceries,-1302
30-01-2024 17:00,1364,1313,West,59,1006,969,Electronics,51
30-01-2024 18:00,4371,2321,East,65,1145,395,Groceries,2050
30-01-2024 19:00,4078,1519,East,83,1368,333,Furniture,2559
30-01-2024 20:00,4832,2635,North,80,1726,440,Furniture,2197
30-01-2024 21:00,3475,1586,North,85,991,692,Clothing,1889
30-01-2024 22:00,2140,1421,South,90,794,292,Furniture,719
30-01-2024 23:00,1579,1910,West,54,956,982,Clothing,-331
31-01-2024 00:00,4578,1982,West,82,1669,463,Clothing,2596
31-01-2024 01:00,1545,2159,North,92,1761,357,Electronics,-614
31-01-2024 02:00,2729,2417,North,68,1239,610,Groceries,312
31-01-2024 03:00,3372,1296,North,81,923,330,Furniture,2076
31-01-2024 04:00,1054,2457,South,72,1507,113,Groceries,-1403
31-01-2024 05:00,1777,1512,West,52,791,113,Clothing,265
31-01-2024 06:00,4039,845,South,50,655,655,Furniture,3194
31-01-2024 07:00,1041,1223,East,85,849,309,Groceries,-182
31-01-2024 08:00,2320,1601,East,90,1965,139,Furniture,719
31-01-2024 09:00,1230,1888,West,77,742,133,Electronics,-658
31-01-2024 10:00,1452,1537,North,97,1730,846,Furniture,-85
31-01-2024 11:00,4961,635,North,88,1951,932,Clothing,4326
31-01-2024 12:00,3441,1827,South,54,1471,333,Furniture,1614
31-01-2024 13:00,2545,2944,East,62,757,885,Electronics,-399
31-01-2024 14:00,2381,1291,East,60,1084,979,Electronics,1090
31-01-2024 15:00,2467,578,West,95,534,389,Groceries,1889
31-01-2024 16:00,2151,2278,East,71,1652,954,Electronics,-127
31-01-2024 17:00,3738,1204,North,98,929,532,Clothing,2534
31-01-2024 18:00,4476,1481,North,72,1842,947,Electronics,2995
31-01-2024 19:00,3439,1941,North,61,594,840,Groceries,1498
31-01-2024 20:00,2216,1765,West,70,719,991,Electronics,451
31-01-2024 21:00,3651,1574,South,68,800,417,Electronics,2077
31-01-2024 22:00,1880,1243,East,54,1708,739,Furniture,637
31-01-2024 23:00,4814,2931,West,73,1560,937,Groceries,1883
01-02-2024 00:00,4149,874,South,79,1274,507,Furniture,3275
01-02-2024 01:00,1084,2253,West,57,899,820,Groceries,-1169
01-02-2024 02:00,2053,2753,East,51,1189,915,Groceries,-700
01-02-2024 03:00,4796,2491,North,98,1665,179,Groceries,2305
01-02-2024 04:00,1048,1834,South,83,1492,906,Groceries,-786
01-02-2024 05:00,4848,1091,South,72,633,275,Groceries,3757
01-02-2024 06:00,2168,1565,West,52,1968,844,Groceries,603
01-02-2024 07:00,1068,1032,West,73,1160,937,Electronics,36
01-02-2024 08:00,4129,1676,North,67,1811,947,Electronics,2453
01-02-2024 09:00,3744,1835,West,96,757,876,Electronics,1909
01-02-2024 10:00,4645,1817,East,86,1562,384,Clothing,2828
01-02-2024 11:00,3526,1097,East,98,804,729,Groceries,2429
01-02-2024 12:00,3867,612,East,80,1806,777,Electronics,3255
01-02-2024 13:00,4516,1635,East,63,1025,417,Groceries,2881
01-02-2024 14:00,4367,1698,North,50,906,509,Furniture,2669
01-02-2024 15:00,2701,2345,North,63,1882,241,Clothing,356
01-02-2024 16:00,4242,1825,North,90,1385,346,Groceries,2417
01-02-2024 17:00,2598,2487,West,54,877,276,Electronics,111
01-02-2024 18:00,3194,2039,North,80,968,910,Clothing,1155
01-02-2024 19:00,4555,1233,South,80,1372,443,Furniture,3322
01-02-2024 20:00,4377,2485,South,79,1489,363,Groceries,1892
01-02-2024 21:00,4744,2865,South,85,1804,267,Clothing,1879
01-02-2024 22:00,4724,1495,West,50,510,124,Groceries,3229
01-02-2024 23:00,2869,2760,West,52,1174,802,Clothing,109
02-02-2024 00:00,2015,752,North,69,1194,999,Electronics,1263
02-02-2024 01:00,3656,623,East,92,1709,626,Groceries,3033
02-02-2024 02:00,1445,1736,South,97,1472,627,Groceries,-291
02-02-2024 03:00,3268,1123,West,92,508,409,Groceries,2145
02-02-2024 04:00,4626,2039,South,70,527,738,Electronics,2587
02-02-2024 05:00,4875,2155,North,79,1322,878,Clothing,2720
02-02-2024 06:00,2401,1766,West,91,1185,127,Electronics,635
02-02-2024 07:00,4691,1660,East,93,1987,874,Furniture,3031
02-02-2024 08:00,4337,2794,East,79,1010,469,Furniture,1543
02-02-2024 09:00,3142,940,West,54,1001,483,Furniture,2202
02-02-2024 10:00,1261,2592,East,59,1081,393,Clothing,-1331
02-02-2024 11:00,2848,1516,North,73,1277,763,Groceries,1332
02-02-2024 12:00,1896,1053,East,94,1160,578,Clothing,843
02-02-2024 13:00,2094,1308,South,88,1741,679,Furniture,786
02-02-2024 14:00,3266,1470,South,97,1952,136,Clothing,1796
02-02-2024 15:00,2556,1612,South,55,502,987,Groceries,944
02-02-2024 16:00,1091,2333,West,59,1710,646,Groceries,-1242
02-02-2024 17:00,1126,1814,West,91,542,745,Clothing,-688
02-02-2024 18:00,1079,1774,West,92,1274,977,Furniture,-695
02-02-2024 19:00,2847,598,West,59,1934,772,Groceries,2249
02-02-2024 20:00,4309,1979,West,74,1713,471,Furniture,2330
02-02-2024 21:00,1982,2114,North,63,541,835,Groceries,-132
02-02-2024 22:00,4443,800,West,96,1620,721,Furniture,3643
02-02-2024 23:00,1915,1722,East,88,1229,201,Clothing,193
03-02-2024 00:00,3533,2182,North,62,1147,454,Electronics,1351
03-02-2024 01:00,1693,987,West,60,1156,564,Electronics,706
03-02-2024 02:00,1024,1924,East,88,1380,793,Furniture,-900
03-02-2024 03:00,1155,1504,North,60,1659,579,Groceries,-349
03-02-2024 04:00,4588,976,South,95,1009,758,Clothing,3612
03-02-2024 05:00,3679,1645,North,98,536,315,Groceries,2034
03-02-2024 06:00,2812,1835,West,65,1322,750,Electronics,977
03-02-2024 07:00,2553,1635,North,82,1078,426,Electronics,918
03-02-2024 08:00,2966,2205,North,90,1336,799,Clothing,761
03-02-2024 09:00,2733,1017,South,90,1016,699,Furniture,1716
03-02-2024 10:00,2080,1720,North,81,1284,346,Clothing,360
03-02-2024 11:00,2628,729,North,59,1520,797,Electronics,1899
03-02-2024 12:00,1018,1691,South,64,1378,187,Clothing,-673
03-02-2024 13:00,2407,2555,West,65,1581,433,Electronics,-148
03-02-2024 14:00,4936,2477,East,92,1458,763,Groceries,2459
03-02-2024 15:00,2216,1883,North,76,654,878,Electronics,333
03-02-2024 16:00,3284,2742,South,98,612,299,Electronics,542
03-02-2024 17:00,2410,2901,North,94,1983,482,Clothing,-491
03-02-2024 18:00,4497,2387,West,81,1335,527,Clothing,2110
03-02-2024 19:00,1276,1572,West,55,1100,434,Clothing,-296
03-02-2024 20:00,4298,963,South,96,941,857,Groceries,3335
03-02-2024 21:00,1744,2903,East,97,727,549,Clothing,-1159
03-02-2024 22:00,1551,1473,East,85,1373,315,Groceries,78
03-02-2024 23:00,4394,1681,North,57,1645,685,Furniture,2713
04-02-2024 00:00,2176,565,South,74,1170,771,Clothing,1611
04-02-2024 01:00,1638,2496,East,56,1880,354,Clothing,-858
04-02-2024 02:00,1236,1070,West,66,1791,628,Furniture,166
04-02-2024 03:00,1997,807,East,97,1194,604,Furniture,1190
04-02-2024 04:00,3102,1282,South,79,1368,537,Furniture,1820
04-02-2024 05:00,3003,620,West,51,1527,749,Electronics,2383
04-02-2024 06:00,2459,1265,North,66,620,569,Electronics,1194
04-02-2024 07:00,3731,1272,West,53,1241,105,Electronics,2459
04-02-2024 08:00,3156,2643,East,75,1742,318,Furniture,513
04-02-2024 09:00,4937,1486,East,63,1193,612,Groceries,3451
04-02-2024 10:00,2207,2509,East,57,1801,675,Clothing,-302
04-02-2024 11:00,2391,1039,North,54,756,820,Electronics,1352
04-02-2024 12:00,3006,2549,East,54,1827,612,Furniture,457
04-02-2024 13:00,2221,1079,South,54,542,968,Clothing,1142
04-02-2024 14:00,2394,2163,North,76,1369,288,Electronics,231
04-02-2024 15:00,1372,2880,West,54,1415,346,Furniture,-1508
04-02-2024 16:00,4020,1547,East,52,1087,868,Clothing,2473
04-02-2024 17:00,2520,1005,South,87,1412,785,Electronics,1515
04-02-2024 18:00,4670,2410,South,79,1673,720,Electronics,2260
04-02-2024 19:00,3248,1232,North,50,1093,671,Electronics,2016
04-02-2024 20:00,1848,2071,South,57,1533,654,Electronics,-223
04-02-2024 21:00,3556,1013,North,62,1291,527,Electronics,2543
04-02-2024 22:00,2345,860,North,69,711,649,Furniture,1485
04-02-2024 23:00,3322,2821,North,55,1783,462,Clothing,501
05-02-2024 00:00,3258,2724,West,99,1905,869,Electronics,534
05-02-2024 01:00,1503,1026,West,99,1912,693,Clothing,477
05-02-2024 02:00,4974,778,South,97,1421,495,Electronics,4196
05-02-2024 03:00,4189,1872,West,57,835,832,Furniture,2317
05-02-2024 04:00,1702,2446,North,79,1528,722,Furniture,-744
05-02-2024 05:00,4625,1944,North,98,1421,876,Clothing,2681
05-02-2024 06:00,3089,2611,West,89,582,235,Electronics,478
05-02-2024 07:00,1314,789,South,64,1529,533,Furniture,525
05-02-2024 08:00,3835,2565,North,59,651,947,Electronics,1270
05-02-2024 09:00,3376,563,West,82,1704,417,Electronics,2813
05-02-2024 10:00,2040,829,East,58,1690,634,Groceries,1211
05-02-2024 11:00,1282,2393,South,98,1993,600,Furniture,-1111
05-02-2024 12:00,3990,1262,South,82,577,448,Clothing,2728
05-02-2024 13:00,1257,2463,South,58,911,158,Clothing,-1206
05-02-2024 14:00,1574,2990,East,63,880,877,Electronics,-1416
05-02-2024 15:00,1573,640,North,81,1447,239,Electronics,933
05-02-2024 16:00,3659,1831,South,86,1289,992,Electronics,1828
05-02-2024 17:00,2042,943,West,55,812,727,Groceries,1099
05-02-2024 18:00,2552,2973,South,54,1363,303,Electronics,-421
05-02-2024 19:00,3884,1998,West,53,894,257,Electronics,1886
05-02-2024 20:00,1422,1768,South,97,1042,429,Clothing,-346
05-02-2024 21:00,2489,949,West,65,503,295,Groceries,1540
05-02-2024 22:00,2396,2325,West,59,608,530,Clothing,71
05-02-2024 23:00,1757,850,West,80,1417,823,Groceries,907
06-02-2024 00:00,3810,1098,East,80,1385,652,Groceries,2712
06-02-2024 01:00,2104,1210,East,63,592,970,Furniture,894
06-02-2024 02:00,2574,1369,East,62,1622,618,Furniture,1205
06-02-2024 03:00,4619,2483,North,53,691,961,Furniture,2136
06-02-2024 04:00,3471,1684,West,95,832,983,Clothing,1787
06-02-2024 05:00,1428,892,North,75,1735,716,Furniture,536
06-02-2024 06:00,4459,1341,East,73,1730,571,Furniture,3118
06-02-2024 07:00,3021,2948,West,58,1126,557,Clothing,73
06-02-2024 08:00,4992,2597,North,84,1485,919,Groceries,2395
06-02-2024 09:00,4780,1818,East,91,1072,144,Groceries,2962
06-02-2024 10:00,4741,1535,North,64,855,137,Electronics,3206
06-02-2024 11:00,1203,1858,North,73,1776,775,Electronics,-655
06-02-2024 12:00,3243,1490,East,80,1090,692,Furniture,1753
06-02-2024 13:00,3775,1538,West,68,695,440,Clothing,2237
06-02-2024 14:00,3332,527,South,51,761,669,Groceries,2805
06-02-2024 15:00,2992,887,South,51,821,401,Clothing,2105
06-02-2024 16:00,3243,1815,North,90,919,734,Electronics,1428
06-02-2024 17:00,1306,1332,North,85,831,806,Furniture,-26
06-02-2024 18:00,2687,749,North,86,1819,292,Electronics,1938
06-02-2024 19:00,1013,2527,West,83,1759,997,Electronics,-1514
06-02-2024 20:00,2860,2028,North,88,1180,715,Groceries,832
06-02-2024 21:00,4217,597,North,68,506,723,Clothing,3620
06-02-2024 22:00,2961,2338,North,87,1033,231,Groceries,623
06-02-2024 23:00,2080,1860,East,72,571,707,Groceries,220
07-02-2024 00:00,1722,1562,South,65,1117,694,Electronics,160
07-02-2024 01:00,1779,1823,South,95,638,567,Furniture,-44
07-02-2024 02:00,2233,2726,East,93,1909,269,Electronics,-493
07-02-2024 03:00,1528,1391,West,55,1041,660,Clothing,137
07-02-2024 04:00,1797,1992,West,75,823,984,Furniture,-195
07-02-2024 05:00,1343,1805,West,71,1448,746,Groceries,-462
07-02-2024 06:00,4786,1687,East,94,1100,364,Clothing,3099
07-02-2024 07:00,4682,952,South,96,572,298,Clothing,3730
07-02-2024 08:00,2302,596,South,73,1339,382,Clothing,1706
07-02-2024 09:00,1208,2856,North,95,1912,504,Clothing,-1648
07-02-2024 10:00,1640,761,South,89,1761,646,Electronics,879
07-02-2024 11:00,4406,2840,West,70,1487,955,Clothing,1566
07-02-2024 12:00,2311,2293,West,79,1845,579,Electronics,18
07-02-2024 13:00,3299,2796,North,60,1864,303,Furniture,503
07-02-2024 14:00,4336,2792,North,58,1828,570,Clothing,1544
07-02-2024 15:00,3318,2798,South,61,1531,852,Electronics,520
07-02-2024 16:00,2947,2670,North,75,1730,448,Clothing,277
07-02-2024 17:00,1919,824,North,87,910,934,Furniture,1095
07-02-2024 18:00,2723,1485,East,52,757,142,Groceries,1238
07-02-2024 19:00,3044,1186,South,82,1150,875,Furniture,1858
07-02-2024 20:00,1418,2239,West,64,1569,581,Groceries,-821
07-02-2024 21:00,2749,2360,East,96,625,476,Electronics,389
07-02-2024 22:00,3842,1335,West,54,1544,177,Furniture,2507
07-02-2024 23:00,4282,558,North,73,1693,135,Electronics,3724
08-02-2024 00:00,2388,2021,North,60,1043,482,Furniture,367
08-02-2024 01:00,2099,1896,West,82,1939,915,Clothing,203
08-02-2024 02:00,4731,2813,East,72,954,273,Groceries,1918
08-02-2024 03:00,4392,2176,East,59,1161,746,Clothing,2216
08-02-2024 04:00,3772,735,East,92,1729,429,Electronics,3037
08-02-2024 05:00,3480,717,North,77,1856,751,Clothing,2763
08-02-2024 06:00,3156,2050,South,88,1544,154,Groceries,1106
08-02-2024 07:00,3688,2337,North,66,1417,863,Groceries,1351
08-02-2024 08:00,2545,1929,West,93,1588,378,Groceries,616
08-02-2024 09:00,2070,1088,East,75,587,558,Groceries,982
08-02-2024 10:00,3426,2171,South,74,1566,791,Groceries,1255
08-02-2024 11:00,2850,1416,East,85,1664,624,Electronics,1434
08-02-2024 12:00,2119,1992,North,61,1897,815,Clothing,127
08-02-2024 13:00,1957,1417,South,52,1015,554,Furniture,540
08-02-2024 14:00,1102,1633,South,99,999,920,Clothing,-531
08-02-2024 15:00,3939,2900,North,78,1802,674,Clothing,1039
08-02-2024 16:00,3901,2336,East,93,825,591,Electronics,1565
08-02-2024 17:00,2169,2638,East,73,1941,173,Electronics,-469
08-02-2024 18:00,2903,2405,East,68,1052,554,Electronics,498
08-02-2024 19:00,4999,1201,North,62,1387,918,Electronics,3798
08-02-2024 20:00,4098,2620,West,65,1495,254,Clothing,1478
08-02-2024 21:00,2755,1821,West,89,1492,618,Groceries,934
08-02-2024 22:00,3577,2028,East,76,1428,474,Groceries,1549
08-02-2024 23:00,1678,1721,South,55,1420,405,Electronics,-43
09-02-2024 00:00,2968,1555,West,91,807,442,Furniture,1413
09-02-2024 01:00,1988,1147,East,59,1156,764,Clothing,841
09-02-2024 02:00,2105,1259,West,87,1830,143,Clothing,846
09-02-2024 03:00,3475,1857,East,57,969,647,Furniture,1618
09-02-2024 04:00,2607,2690,West,67,1707,540,Electronics,-83
09-02-2024 05:00,3869,2269,West,81,1124,196,Clothing,1600
09-02-2024 06:00,2502,1448,South,66,790,264,Furniture,1054
09-02-2024 07:00,2789,2591,South,91,748,845,Groceries,198
09-02-2024 08:00,2185,2579,West,51,823,202,Furniture,-394
09-02-2024 09:00,4910,2266,East,93,1966,535,Furniture,2644
09-02-2024 10:00,1931,527,South,69,1103,480,Electronics,1404
09-02-2024 11:00,2425,2970,North,59,558,546,Clothing,-545
09-02-2024 12:00,4579,659,South,58,1520,106,Furniture,3920
09-02-2024 13:00,2061,1730,West,97,768,193,Clothing,331
09-02-2024 14:00,2978,517,West,88,1841,543,Clothing,2461
09-02-2024 15:00,3558,1626,North,90,593,578,Electronics,1932
09-02-2024 16:00,3440,2779,South,74,1777,732,Groceries,661
09-02-2024 17:00,3042,2971,West,74,1186,976,Clothing,71
09-02-2024 18:00,3760,1403,North,73,1983,593,Electronics,2357
09-02-2024 19:00,3541,1254,North,55,1014,136,Electronics,2287
09-02-2024 20:00,4271,2070,East,79,1032,632,Furniture,2201
09-02-2024 21:00,2278,1336,South,59,1627,197,Clothing,942
09-02-2024 22:00,2202,1393,South,88,901,913,Electronics,809
09-02-2024 23:00,3594,2786,South,80,1466,120,Groceries,808
10-02-2024 00:00,1593,2696,West,67,1856,331,Furniture,-1103
10-02-2024 01:00,3436,1931,North,92,1220,567,Groceries,1505
10-02-2024 02:00,2421,516,East,82,1376,453,Electronics,1905
10-02-2024 03:00,4803,2773,South,68,1107,171,Furniture,2030
10-02-2024 04:00,3205,1151,East,72,592,451,Clothing,2054
10-02-2024 05:00,2027,2179,East,54,1073,151,Furniture,-152
10-02-2024 06:00,3214,759,North,75,1470,321,Furniture,2455
10-02-2024 07:00,4539,2252,South,78,936,896,Groceries,2287
10-02-2024 08:00,1959,2127,East,73,1533,424,Clothing,-168
10-02-2024 09:00,3456,2547,South,55,955,559,Electronics,909
10-02-2024 10:00,4483,2721,South,88,914,266,Groceries,1762
10-02-2024 11:00,4275,2366,South,53,1898,382,Clothing,1909
10-02-2024 12:00,3241,704,East,97,1896,600,Electronics,2537
10-02-2024 13:00,3282,2962,North,91,1203,816,Furniture,320
10-02-2024 14:00,3765,1676,North,75,1381,466,Clothing,2089
10-02-2024 15:00,2173,1291,East,64,1261,749,Groceries,882
10-02-2024 16:00,4230,1640,West,62,1962,135,Electronics,2590
10-02-2024 17:00,4350,1605,South,89,1718,706,Electronics,2745
10-02-2024 18:00,1815,2357,South,71,764,627,Clothing,-542
10-02-2024 19:00,1403,1590,North,62,1006,848,Clothing,-187
10-02-2024 20:00,1892,2107,East,88,1145,775,Furniture,-215
10-02-2024 21:00,3725,2339,East,66,1396,701,Electronics,1386
10-02-2024 22:00,4382,1478,West,85,1949,719,Furniture,2904
10-02-2024 23:00,1067,566,West,88,1360,695,Furniture,501
11-02-2024 00:00,4534,1183,North,97,1188,354,Groceries,3351
11-02-2024 01:00,1087,1778,West,74,1366,776,Groceries,-691
11-02-2024 02:00,3264,562,West,83,1622,299,Clothing,2702
11-02-2024 03:00,3048,1313,East,70,1553,935,Clothing,1735
11-02-2024 04:00,2158,902,East,74,1814,926,Clothing,1256
11-02-2024 05:00,2720,2739,West,74,986,768,Groceries,-19
11-02-2024 06:00,2374,2502,North,71,1929,130,Furniture,-128
11-02-2024 07:00,3187,1852,West,72,527,677,Furniture,1335
11-02-2024 08:00,3665,570,North,74,1669,700,Groceries,3095
11-02-2024 09:00,3180,1586,West,63,787,585,Clothing,1594
11-02-2024 10:00,2643,744,East,63,1080,358,Clothing,1899
11-02-2024 11:00,1177,892,East,75,1449,352,Furniture,285
11-02-2024 12:00,3857,1271,North,89,751,593,Electronics,2586
11-02-2024 13:00,2381,2169,West,79,1685,333,Electronics,212
11-02-2024 14:00,3427,2117,West,75,1426,206,Electronics,1310
11-02-2024 15:00,1907,2056,North,87,609,680,Electronics,-149
11-02-2024 16:00,4942,1651,West,71,1143,889,Clothing,3291
11-02-2024 17:00,3705,1718,South,88,897,435,Groceries,1987
11-02-2024 18:00,3497,1717,East,88,1794,812,Groceries,1780
11-02-2024 19:00,1585,2731,East,83,1711,152,Electronics,-1146
11-02-2024 20:00,3510,746,North,74,775,852,Groceries,2764
11-02-2024 21:00,1989,2542,West,85,1188,943,Furniture,-553
11-02-2024 22:00,2131,2871,North,62,746,786,Electronics,-740
11-02-2024 23:00,3169,2707,South,78,1847,141,Clothing,462
12-02-2024 00:00,3064,1205,West,91,1541,359,Electronics,1859
12-02-2024 01:00,2219,2613,South,58,907,468,Furniture,-394
12-02-2024 02:00,3374,753,North,64,1934,309,Groceries,2621
12-02-2024 03:00,1317,782,East,80,624,565,Groceries,535
12-02-2024 04:00,3856,2665,South,93,1843,141,Groceries,1191
12-02-2024 05:00,2502,922,West,76,652,452,Clothing,1580
12-02-2024 06:00,3034,2521,North,80,1157,781,Electronics,513
12-02-2024 07:00,4323,535,North,59,519,993,Clothing,3788
12-02-2024 08:00,3042,1030,North,86,746,358,Furniture,2012
12-02-2024 09:00,1502,590,East,56,1913,436,Clothing,912
12-02-2024 10:00,3022,2440,North,81,1870,815,Electronics,582
12-02-2024 11:00,1118,2442,North,60,1999,494,Groceries,-1324
12-02-2024 12:00,4745,1740,East,97,1726,948,Groceries,3005
12-02-2024 13:00,1709,2258,North,94,1532,774,Groceries,-549
12-02-2024 14:00,4569,597,North,77,1030,204,Groceries,3972
12-02-2024 15:00,4557,1979,South,53,602,789,Clothing,2578
12-02-2024 16:00,1044,1030,North,97,1769,802,Electronics,14
12-02-2024 17:00,1313,2332,East,94,1096,223,Electronics,-1019
12-02-2024 18:00,4250,1551,South,80,1842,809,Electronics,2699
12-02-2024 19:00,4965,1847,North,78,850,198,Clothing,3118
12-02-2024 20:00,1417,579,East,82,733,105,Groceries,838
12-02-2024 21:00,3603,1981,West,53,536,899,Groceries,1622
12-02-2024 22:00,4854,1113,North,96,1868,366,Electronics,3741
12-02-2024 23:00,2101,2723,West,75,791,142,Groceries,-622
13-02-2024 00:00,1325,2272,South,80,516,906,Clothing,-947
13-02-2024 01:00,4761,1980,East,80,589,752,Furniture,2781
13-02-2024 02:00,4428,922,South,76,1871,368,Groceries,3506
13-02-2024 03:00,2439,1623,West,74,1176,650,Furniture,816
13-02-2024 04:00,2986,2534,West,97,1476,773,Furniture,452
13-02-2024 05:00,3562,1903,West,85,1967,294,Furniture,1659
13-02-2024 06:00,3261,831,East,98,752,423,Groceries,2430
13-02-2024 07:00,4925,1152,West,80,1316,715,Furniture,3773
13-02-2024 08:00,1073,1239,West,92,683,856,Groceries,-166
13-02-2024 09:00,4634,1612,East,86,789,164,Electronics,3022
13-02-2024 10:00,2602,2127,West,94,1260,300,Clothing,475
13-02-2024 11:00,1508,1010,North,93,1738,980,Furniture,498
13-02-2024 12:00,3379,541,West,72,657,341,Furniture,2838
13-02-2024 13:00,4164,1384,East,84,1422,106,Electronics,2780
13-02-2024 14:00,1687,2449,West,53,1190,318,Clothing,-762
13-02-2024 15:00,1656,2628,East,77,892,102,Electronics,-972
13-02-2024 16:00,2542,901,West,91,1543,953,Clothing,1641
13-02-2024 17:00,2292,2654,North,90,1994,563,Furniture,-362
13-02-2024 18:00,2399,1634,East,91,930,404,Clothing,765
13-02-2024 19:00,4905,1737,East,62,1496,413,Electronics,3168
13-02-2024 20:00,4075,2266,East,50,1504,577,Furniture,1809
13-02-2024 21:00,4209,2341,East,61,1591,895,Electronics,1868
13-02-2024 22:00,4302,1005,West,92,1600,982,Furniture,3297
13-02-2024 23:00,3647,1644,West,89,601,510,Groceries,2003
14-02-2024 00:00,2552,2341,North,75,1151,597,Furniture,211
14-02-2024 01:00,2075,1219,North,95,1392,633,Clothing,856
14-02-2024 02:00,4717,1894,West,95,1084,705,Clothing,2823
14-02-2024 03:00,4794,756,South,72,706,456,Clothing,4038
14-02-2024 04:00,1324,2220,East,98,712,170,Clothing,-896
14-02-2024 05:00,1991,2321,West,71,578,981,Clothing,-330
14-02-2024 06:00,2993,1453,North,77,1636,833,Groceries,1540
14-02-2024 07:00,4976,1571,East,66,632,112,Furniture,3405
14-02-2024 08:00,4802,2122,North,55,1720,505,Furniture,2680
14-02-2024 09:00,1716,1396,South,63,1548,616,Groceries,320
14-02-2024 10:00,3770,2566,East,99,971,121,Groceries,1204
14-02-2024 11:00,1276,1569,South,66,789,994,Clothing,-293
14-02-2024 12:00,3583,950,South,87,1779,408,Electronics,2633
14-02-2024 13:00,4557,1397,South,54,1729,394,Electronics,3160
14-02-2024 14:00,4587,1579,West,62,1998,648,Clothing,3008
14-02-2024 15:00,1151,1240,North,97,1506,130,Groceries,-89
14-02-2024 16:00,1954,581,East,58,1591,161,Furniture,1373
14-02-2024 17:00,2506,1236,West,93,1738,320,Electronics,1270
14-02-2024 18:00,1258,578,North,91,1133,458,Electronics,680
14-02-2024 19:00,3371,2185,West,75,921,692,Groceries,1186
14-02-2024 20:00,4064,2830,North,62,1057,482,Clothing,1234
14-02-2024 21:00,1868,1834,East,68,1080,844,Furniture,34
14-02-2024 22:00,2191,1496,East,97,1038,617,Clothing,695
14-02-2024 23:00,1687,2707,East,66,961,716,Clothing,-1020
15-02-2024 00:00,1309,1839,East,65,1978,436,Clothing,-530
15-02-2024 01:00,3850,2502,North,79,1505,261,Clothing,1348
15-02-2024 02:00,2502,2191,West,81,800,954,Electronics,311
15-02-2024 03:00,4127,1679,East,63,1811,663,Groceries,2448
15-02-2024 04:00,3667,2237,East,97,1525,257,Furniture,1430
15-02-2024 05:00,1472,1352,East,64,1543,112,Electronics,120
15-02-2024 06:00,4367,961,South,61,1453,285,Furniture,3406
15-02-2024 07:00,3508,616,East,86,1485,833,Furniture,2892
15-02-2024 08:00,4395,2189,East,60,1305,852,Electronics,2206
15-02-2024 09:00,1813,2911,North,54,756,408,Electronics,-1098
15-02-2024 10:00,1845,2154,South,60,952,247,Furniture,-309
15-02-2024 11:00,2164,2234,North,83,937,154,Furniture,-70
15-02-2024 12:00,1666,2436,West,68,897,670,Groceries,-770
15-02-2024 13:00,3309,965,South,75,1676,809,Electronics,2344
15-02-2024 14:00,2808,2298,North,75,1148,709,Electronics,510
15-02-2024 15:00,2443,2731,North,66,721,767,Furniture,-288
15-02-2024 16:00,2767,1159,West,80,1959,861,Furniture,1608
15-02-2024 17:00,2264,2622,West,68,635,791,Clothing,-358
15-02-2024 18:00,1354,2214,East,93,1125,609,Furniture,-860
15-02-2024 19:00,2872,1294,East,69,1275,685,Furniture,1578
15-02-2024 20:00,3024,2086,South,72,1802,672,Groceries,938
15-02-2024 21:00,3817,1086,South,74,1084,144,Furniture,2731
15-02-2024 22:00,4832,1134,West,77,984,746,Clothing,3698
15-02-2024 23:00,4660,1774,South,86,1768,821,Clothing,2886
16-02-2024 00:00,1179,1653,East,61,1541,185,Electronics,-474
16-02-2024 01:00,1065,857,West,97,1376,881,Clothing,208
16-02-2024 02:00,1819,1931,North,50,1666,391,Electronics,-112
16-02-2024 03:00,2371,2384,West,51,1000,363,Furniture,-13
16-02-2024 04:00,1170,2018,South,59,592,367,Clothing,-848
16-02-2024 05:00,3521,1121,East,83,1906,324,Groceries,2400
16-02-2024 06:00,3581,981,East,81,778,315,Groceries,2600
16-02-2024 07:00,2390,1479,North,74,1972,973,Clothing,911
16-02-2024 08:00,2130,2373,North,59,1481,330,Electronics,-243
16-02-2024 09:00,3486,1477,West,99,1120,801,Electronics,2009
16-02-2024 10:00,1834,2037,East,50,1811,753,Electronics,-203
16-02-2024 11:00,1226,2837,North,81,975,276,Clothing,-1611
16-02-2024 12:00,4515,1820,North,86,1381,662,Furniture,2695
16-02-2024 13:00,1441,2204,West,61,1171,801,Furniture,-763
16-02-2024 14:00,3443,2494,West,98,1300,616,Furniture,949
16-02-2024 15:00,1727,2570,East,67,670,822,Electronics,-843
16-02-2024 16:00,2604,1305,South,79,871,806,Clothing,1299
16-02-2024 17:00,3131,2719,South,62,1231,612,Groceries,412
16-02-2024 18:00,4686,1334,East,52,1916,203,Furniture,3352
16-02-2024 19:00,4622,2865,South,70,684,972,Furniture,1757
16-02-2024 20:00,2036,1407,East,91,1955,200,Electronics,629
16-02-2024 21:00,2832,1354,East,63,1438,739,Furniture,1478
16-02-2024 22:00,2848,1415,North,89,1334,964,Clothing,1433
16-02-2024 23:00,3740,1342,South,59,708,404,Furniture,2398
17-02-2024 00:00,1492,631,East,51,1493,860,Electronics,861
17-02-2024 01:00,4339,1616,South,94,1299,450,Clothing,2723
17-02-2024 02:00,2548,1360,South,86,1852,902,Electronics,1188
17-02-2024 03:00,2143,793,West,60,1884,550,Groceries,1350
17-02-2024 04:00,1969,1499,South,50,1967,368,Furniture,470
17-02-2024 05:00,3400,2939,East,75,1964,471,Clothing,461
17-02-2024 06:00,4128,2796,North,91,868,137,Clothing,1332
17-02-2024 07:00,3087,1760,South,62,1629,945,Furniture,1327
17-02-2024 08:00,4957,786,East,77,1223,861,Groceries,4171
17-02-2024 09:00,4407,2824,West,85,1848,832,Groceries,1583
17-02-2024 10:00,1639,2934,South,70,1755,162,Furniture,-1295
17-02-2024 11:00,1172,949,North,59,1504,864,Furniture,223
17-02-2024 12:00,2570,2838,South,61,1336,604,Furniture,-268
17-02-2024 13:00,1258,2990,East,95,1772,364,Electronics,-1732
17-02-2024 14:00,4959,1707,South,76,1840,775,Clothing,3252
17-02-2024 15:00,1516,2278,South,52,763,634,Clothing,-762
17-02-2024 16:00,3777,2469,West,77,1786,178,Furniture,1308
17-02-2024 17:00,1522,975,South,51,1181,729,Electronics,547
17-02-2024 18:00,2917,752,North,77,1939,284,Electronics,2165
17-02-2024 19:00,3886,1919,South,80,1412,594,Clothing,1967
17-02-2024 20:00,3164,2836,West,92,569,670,Groceries,328
17-02-2024 21:00,3231,1735,East,70,1757,469,Furniture,1496
17-02-2024 22:00,2929,1499,South,56,931,914,Furniture,1430
17-02-2024 23:00,4945,520,South,99,1577,863,Electronics,4425
18-02-2024 00:00,2139,815,West,80,669,700,Clothing,1324
18-02-2024 01:00,3209,1961,West,63,535,840,Electronics,1248
18-02-2024 02:00,4650,1946,West,88,758,954,Groceries,2704
18-02-2024 03:00,4783,1756,South,88,750,430,Clothing,3027
18-02-2024 04:00,3590,2670,North,58,512,539,Furniture,920
18-02-2024 05:00,4658,1459,West,72,1170,337,Clothing,3199
18-02-2024 06:00,4308,2761,East,61,1040,391,Clothing,1547
18-02-2024 07:00,1838,2445,South,78,556,525,Furniture,-607
18-02-2024 08:00,2089,1338,East,87,1503,394,Groceries,751
18-02-2024 09:00,2093,1467,East,88,1684,932,Electronics,626
18-02-2024 10:00,4880,2353,North,71,936,599,Groceries,2527
18-02-2024 11:00,3494,1099,East,53,1277,655,Groceries,2395
18-02-2024 12:00,3463,1291,West,97,729,944,Groceries,2172
18-02-2024 13:00,3579,539,West,56,1330,691,Clothing,3040
18-02-2024 14:00,3488,1147,South,89,1340,785,Groceries,2341
18-02-2024 15:00,3785,681,North,57,1716,752,Clothing,3104
18-02-2024 16:00,2969,764,North,84,1119,136,Clothing,2205
18-02-2024 17:00,3511,1362,East,58,856,625,Electronics,2149
18-02-2024 18:00,4992,931,North,62,851,733,Electronics,4061
18-02-2024 19:00,3443,1719,East,88,1364,496,Groceries,1724
18-02-2024 20:00,3758,1008,East,69,1781,849,Clothing,2750
18-02-2024 21:00,2574,946,North,70,1121,495,Furniture,1628
18-02-2024 22:00,4728,1027,South,96,1134,666,Clothing,3701
18-02-2024 23:00,2580,2253,East,68,1464,121,Electronics,327
19-02-2024 00:00,3442,2128,West,51,1127,439,Furniture,1314
19-02-2024 01:00,3373,1662,West,93,792,594,Clothing,1711
19-02-2024 02:00,4964,1168,North,89,1909,502,Groceries,3796
19-02-2024 03:00,4990,1346,North,79,1328,302,Clothing,3644
19-02-2024 04:00,2114,2617,East,72,733,445,Furniture,-503
19-02-2024 05:00,1749,2270,East,89,1819,114,Groceries,-521
19-02-2024 06:00,2093,2325,West,62,1036,129,Furniture,-232
19-02-2024 07:00,2189,945,East,82,1902,128,Electronics,1244
19-02-2024 08:00,3689,1525,West,81,1304,863,Electronics,2164
19-02-2024 09:00,3261,2271,East,77,1733,259,Clothing,990
19-02-2024 10:00,2875,1859,South,73,1038,728,Clothing,1016
19-02-2024 11:00,4672,518,South,91,1351,769,Electronics,4154
19-02-2024 12:00,4406,2517,West,77,677,719,Furniture,1889
19-02-2024 13:00,2787,1060,South,79,1055,726,Furniture,1727
19-02-2024 14:00,3416,971,South,90,1595,371,Groceries,2445
19-02-2024 15:00,4932,527,North,78,1745,519,Groceries,4405
19-02-2024 16:00,2607,1059,East,83,1447,949,Groceries,1548
19-02-2024 17:00,4748,957,North,71,1322,588,Electronics,3791
19-02-2024 18:00,1048,1444,West,74,727,275,Electronics,-396
19-02-2024 19:00,2075,1699,North,63,1756,330,Electronics,376
19-02-2024 20:00,2312,1483,West,59,1791,895,Clothing,829
19-02-2024 21:00,4861,1367,South,59,753,417,Furniture,3494
19-02-2024 22:00,2649,2576,North,57,1174,861,Electronics,73
19-02-2024 23:00,4310,2479,South,63,505,566,Groceries,1831
20-02-2024 00:00,3180,1325,East,94,546,539,Groceries,1855
20-02-2024 01:00,4046,1315,South,87,1930,155,Electronics,2731
20-02-2024 02:00,3833,2826,East,81,1382,430,Electronics,1007
20-02-2024 03:00,2189,2830,South,94,1079,372,Furniture,-641
20-02-2024 04:00,2397,1502,North,81,753,801,Groceries,895
20-02-2024 05:00,3420,2042,North,52,1972,120,Furniture,1378
20-02-2024 06:00,2828,2852,South,69,558,264,Electronics,-24
20-02-2024 07:00,4549,608,West,62,1916,591,Furniture,3941
20-02-2024 08:00,4826,2871,West,72,1059,982,Clothing,1955
20-02-2024 09:00,1478,1729,East,68,1514,517,Electronics,-251
20-02-2024 10:00,1831,2461,East,65,1714,896,Groceries,-630
20-02-2024 11:00,3697,2463,South,85,764,679,Groceries,1234
20-02-2024 12:00,2614,1421,North,84,1666,366,Furniture,1193
20-02-2024 13:00,1681,1930,East,96,745,829,Electronics,-249
20-02-2024 14:00,4706,2032,South,96,1739,437,Groceries,2674
20-02-2024 15:00,3735,2392,East,99,936,995,Furniture,1343
20-02-2024 16:00,2323,1921,North,56,1187,984,Furniture,402
20-02-2024 17:00,1081,1722,East,86,975,707,Electronics,-641
20-02-2024 18:00,1086,890,South,57,1907,287,Groceries,196
20-02-2024 19:00,3272,2172,East,74,1437,574,Groceries,1100
20-02-2024 20:00,3063,2369,West,72,1377,307,Groceries,694
20-02-2024 21:00,1821,2021,East,59,1156,173,Electronics,-200
20-02-2024 22:00,4429,1695,North,79,1046,975,Electronics,2734
20-02-2024 23:00,1162,2633,North,82,914,773,Electronics,-1471
21-02-2024 00:00,4681,1357,North,60,1655,772,Clothing,3324
21-02-2024 01:00,4739,1709,North,84,897,493,Furniture,3030
21-02-2024 02:00,3561,2016,South,76,1676,589,Clothing,1545
21-02-2024 03:00,3397,2150,East,52,667,671,Clothing,1247
21-02-2024 04:00,2932,1653,East,96,1302,125,Groceries,1279
21-02-2024 05:00,3728,1342,East,98,729,973,Groceries,2386
21-02-2024 06:00,4535,1604,East,99,1202,636,Furniture,2931
21-02-2024 07:00,2850,2325,South,57,1927,869,Furniture,525
21-02-2024 08:00,2860,2182,North,62,643,957,Electronics,678
21-02-2024 09:00,4446,794,East,91,567,951,Groceries,3652
21-02-2024 10:00,2115,2501,East,52,1517,614,Clothing,-386
21-02-2024 11:00,3228,2816,North,69,597,899,Furniture,412
21-02-2024 12:00,3790,1144,West,95,506,356,Furniture,2646
21-02-2024 13:00,4372,2635,West,94,1314,379,Clothing,1737
21-02-2024 14:00,3707,1424,North,84,676,917,Electronics,2283
21-02-2024 15:00,4863,2147,East,62,1729,859,Groceries,2716
